table_id,game_id,player_name,player_type,game_result,game_reason,blind_type,final_hand,beginning_balance,game_start_balance,game_end_balance,game_net_change
21,2001,players_1,AlwaysCallPlayer,won,won_game,None,one_pair,100000,100000,100630.0,630.0
21,2002,players_1,AlwaysCallPlayer,won,won_game,None,three_of_kind,100000,100630.0,100660.0,30.0
21,2003,players_1,AlwaysCallPlayer,lost,lost_game,small,one_pair,100000,100660.0,100650.0,-10.0
21,2004,players_1,AlwaysCallPlayer,won,won_game,big,full_house,100000,100650.0,100680.0,30.0
21,2005,players_1,AlwaysCallPlayer,lost,lost_game,None,two_pair,100000,100680.0,100670.0,-10.0
21,2006,players_1,AlwaysCallPlayer,lost,lost_game,None,one_pair,100000,100670.0,99960.0,-710.0
21,2007,players_1,AlwaysCallPlayer,lost,lost_game,small,high_card,100000,99960.0,99650.0,-310.0
21,2008,players_1,AlwaysCallPlayer,lost,lost_game,big,one_pair,100000,99650.0,99640.0,-10.0
21,2009,players_1,AlwaysCallPlayer,won,won_game,None,two_pair,100000,99640.0,99970.0,330.0
21,2010,players_1,AlwaysCallPlayer,lost,lost_game,None,two_pair,100000,99970.0,99960.0,-10.0
21,2011,players_1,AlwaysCallPlayer,lost,lost_game,small,high_card,100000,99960.0,99950.0,-10.0
21,2012,players_1,AlwaysCallPlayer,won,won_game,big,two_pair,100000,99950.0,100880.0,930.0
21,2013,players_1,AlwaysCallPlayer,lost,lost_game,None,one_pair,100000,100880.0,100870.0,-10.0
21,2014,players_1,AlwaysCallPlayer,won,won_game,None,two_pair,100000,100870.0,100900.0,30.0
21,2015,players_1,AlwaysCallPlayer,lost,lost_game,small,one_pair,100000,100900.0,100690.0,-210.0
21,2016,players_1,AlwaysCallPlayer,lost,lost_game,big,one_pair,100000,100690.0,100680.0,-10.0
21,2017,players_1,AlwaysCallPlayer,lost,lost_game,None,two_pair,100000,100680.0,100670.0,-10.0
21,2018,players_1,AlwaysCallPlayer,lost,lost_game,None,one_pair,100000,100670.0,100660.0,-10.0
21,2019,players_1,AlwaysCallPlayer,won,won_game,small,one_pair,100000,100660.0,100690.0,30.0
21,2020,players_1,AlwaysCallPlayer,lost,lost_game,big,one_pair,100000,100690.0,100480.0,-210.0
21,2021,players_1,AlwaysCallPlayer,lost,lost_game,None,high_card,100000,100480.0,100470.0,-10.0
21,2022,players_1,AlwaysCallPlayer,lost,lost_game,None,high_card,100000,100470.0,100460.0,-10.0
21,2023,players_1,AlwaysCallPlayer,lost,lost_game,small,one_pair,100000,100460.0,100450.0,-10.0
21,2024,players_1,AlwaysCallPlayer,won,won_game,big,two_pair,100000,100450.0,100480.0,30.0
21,2025,players_1,AlwaysCallPlayer,lost,lost_game,None,high_card,100000,100480.0,100270.0,-210.0
21,2026,players_1,AlwaysCallPlayer,lost,lost_game,None,one_pair,100000,100270.0,100260.0,-10.0
21,2027,players_1,AlwaysCallPlayer,won,won_game,small,two_pair,100000,100260.0,100290.0,30.0
21,2028,players_1,AlwaysCallPlayer,won,won_game,big,one_pair,100000,100290.0,100320.0,30.0
21,2029,players_1,AlwaysCallPlayer,lost,lost_game,None,one_pair,100000,100320.0,100310.0,-10.0
21,2030,players_1,AlwaysCallPlayer,won,won_game,None,two_pair,100000,100310.0,100340.0,30.0
21,2031,players_1,AlwaysCallPlayer,lost,lost_game,small,full_house,100000,100340.0,100330.0,-10.0
21,2032,players_1,AlwaysCallPlayer,won,won_game,big,two_pair,100000,100330.0,100660.0,330.0
21,2033,players_1,AlwaysCallPlayer,won,won_game,None,full_house,100000,100660.0,100690.0,30.0
21,2034,players_1,AlwaysCallPlayer,lost,lost_game,None,one_pair,100000,100690.0,100580.0,-110.0
21,2035,players_1,AlwaysCallPlayer,lost,lost_game,small,high_card,100000,100580.0,99970.0,-610.0
21,2036,players_1,AlwaysCallPlayer,lost,lost_game,big,two_pair,100000,99970.0,99960.0,-10.0
21,2037,players_1,AlwaysCallPlayer,won,won_game,None,one_pair,100000,99960.0,99990.0,30.0
21,2038,players_1,AlwaysCallPlayer,lost,lost_game,None,one_pair,100000,99990.0,99980.0,-10.0
21,2039,players_1,AlwaysCallPlayer,lost,lost_game,small,one_pair,100000,99980.0,99970.0,-10.0
21,2040,players_1,AlwaysCallPlayer,won,won_game,big,two_pair,100000,99970.0,100300.0,330.0
21,2041,players_1,AlwaysCallPlayer,won,won_game,None,one_pair,100000,100300.0,100330.0,30.0
21,2042,players_1,AlwaysCallPlayer,lost,lost_game,None,one_pair,100000,100330.0,100120.0,-210.0
21,2043,players_1,AlwaysCallPlayer,won,won_game,small,two_pair,100000,100120.0,100150.0,30.0
21,2044,players_1,AlwaysCallPlayer,lost,lost_game,big,flush,100000,100150.0,100140.0,-10.0
21,2045,players_1,AlwaysCallPlayer,lost,lost_game,None,one_pair,100000,100140.0,99730.0,-410.0
21,2046,players_1,AlwaysCallPlayer,won,won_game,None,three_of_kind,100000,99730.0,99760.0,30.0
21,2047,players_1,AlwaysCallPlayer,lost,lost_game,small,one_pair,100000,99760.0,99750.0,-10.0
21,2048,players_1,AlwaysCallPlayer,won,won_game,big,three_of_kind,100000,99750.0,99780.0,30.0
21,2049,players_1,AlwaysCallPlayer,lost,lost_game,None,one_pair,100000,99780.0,99770.0,-10.0
21,2050,players_1,AlwaysCallPlayer,won,won_game,None,high_card,100000,99770.0,99800.0,30.0
21,2051,players_1,AlwaysCallPlayer,lost,lost_game,small,high_card,100000,99800.0,99790.0,-10.0
21,2052,players_1,AlwaysCallPlayer,lost,lost_game,big,high_card,100000,99790.0,99480.0,-310.0
21,2053,players_1,AlwaysCallPlayer,lost,lost_game,None,two_pair,100000,99480.0,98870.0,-610.0
21,2054,players_1,AlwaysCallPlayer,lost,lost_game,None,two_pair,100000,98870.0,98860.0,-10.0
21,2055,players_1,AlwaysCallPlayer,lost,lost_game,small,one_pair,100000,98860.0,98050.0,-810.0
21,2056,players_1,AlwaysCallPlayer,lost,lost_game,big,one_pair,100000,98050.0,98040.0,-10.0
21,2057,players_1,AlwaysCallPlayer,lost,lost_game,None,one_pair,100000,98040.0,97430.0,-610.0
21,2058,players_1,AlwaysCallPlayer,lost,lost_game,None,one_pair,100000,97430.0,97420.0,-10.0
21,2059,players_1,AlwaysCallPlayer,lost,lost_game,small,one_pair,100000,97420.0,97010.0,-410.0
21,2060,players_1,AlwaysCallPlayer,won,won_game,big,one_pair,100000,97010.0,97040.0,30.0
21,2061,players_1,AlwaysCallPlayer,lost,lost_game,None,one_pair,100000,97040.0,96230.0,-810.0
21,2062,players_1,AlwaysCallPlayer,lost,lost_game,None,one_pair,100000,96230.0,96220.0,-10.0
21,2063,players_1,AlwaysCallPlayer,lost,lost_game,small,one_pair,100000,96220.0,96210.0,-10.0
21,2064,players_1,AlwaysCallPlayer,lost,lost_game,big,one_pair,100000,96210.0,96000.0,-210.0
21,2065,players_1,AlwaysCallPlayer,lost,lost_game,None,high_card,100000,96000.0,95390.0,-610.0
21,2066,players_1,AlwaysCallPlayer,lost,lost_game,None,two_pair,100000,95390.0,95380.0,-10.0
21,2067,players_1,AlwaysCallPlayer,lost,lost_game,small,high_card,100000,95380.0,95370.0,-10.0
21,2068,players_1,AlwaysCallPlayer,won,won_game,big,one_pair,100000,95370.0,95400.0,30.0
21,2069,players_1,AlwaysCallPlayer,lost,lost_game,None,one_pair,100000,95400.0,95390.0,-10.0
21,2070,players_1,AlwaysCallPlayer,won,won_game,None,two_pair,100000,95390.0,95420.0,30.0
21,2071,players_1,AlwaysCallPlayer,won,won_game,small,full_house,100000,95420.0,95450.0,30.0
21,2072,players_1,AlwaysCallPlayer,won,won_game,big,two_pair,100000,95450.0,95480.0,30.0
21,2073,players_1,AlwaysCallPlayer,won,won_game,None,one_pair,100000,95480.0,95510.0,30.0
21,2074,players_1,AlwaysCallPlayer,lost,lost_game,None,straight,100000,95510.0,95500.0,-10.0
21,2075,players_1,AlwaysCallPlayer,lost,lost_game,small,high_card,100000,95500.0,95490.0,-10.0
21,2076,players_1,AlwaysCallPlayer,won,won_game,big,two_pair,100000,95490.0,95520.0,30.0
21,2077,players_1,AlwaysCallPlayer,won,won_game,None,one_pair,100000,95520.0,97950.0,2430.0
21,2078,players_1,AlwaysCallPlayer,lost,lost_game,None,one_pair,100000,97950.0,97540.0,-410.0
21,2079,players_1,AlwaysCallPlayer,lost,lost_game,small,one_pair,100000,97540.0,97530.0,-10.0
21,2080,players_1,AlwaysCallPlayer,lost,lost_game,big,one_pair,100000,97530.0,97320.0,-210.0
21,2081,players_1,AlwaysCallPlayer,lost,lost_game,None,two_pair,100000,97320.0,97310.0,-10.0
21,2082,players_1,AlwaysCallPlayer,won,won_game,None,two_pair,100000,97310.0,97340.0,30.0
21,2083,players_1,AlwaysCallPlayer,won,won_game,small,one_pair,100000,97340.0,97370.0,30.0
21,2084,players_1,AlwaysCallPlayer,lost,lost_game,big,one_pair,100000,97370.0,97360.0,-10.0
21,2085,players_1,AlwaysCallPlayer,lost,lost_game,None,one_pair,100000,97360.0,97350.0,-10.0
21,2086,players_1,AlwaysCallPlayer,lost,lost_game,None,two_pair,100000,97350.0,96640.0,-710.0
21,2087,players_1,AlwaysCallPlayer,lost,lost_game,small,one_pair,100000,96640.0,96630.0,-10.0
21,2088,players_1,AlwaysCallPlayer,lost,lost_game,big,one_pair,100000,96630.0,96220.0,-410.0
21,2089,players_1,AlwaysCallPlayer,lost,lost_game,None,two_pair,100000,96220.0,95610.0,-610.0
21,2090,players_1,AlwaysCallPlayer,lost,lost_game,None,one_pair,100000,95610.0,95600.0,-10.0
21,2091,players_1,AlwaysCallPlayer,lost,lost_game,small,one_pair,100000,95600.0,95590.0,-10.0
21,2092,players_1,AlwaysCallPlayer,lost,lost_game,big,one_pair,100000,95590.0,95580.0,-10.0
21,2093,players_1,AlwaysCallPlayer,lost,lost_game,None,one_pair,100000,95580.0,95570.0,-10.0
21,2094,players_1,AlwaysCallPlayer,lost,lost_game,None,one_pair,100000,95570.0,95560.0,-10.0
21,2095,players_1,AlwaysCallPlayer,won,won_game,small,three_of_kind,100000,95560.0,95590.0,30.0
21,2096,players_1,AlwaysCallPlayer,lost,lost_game,big,two_pair,100000,95590.0,95480.0,-110.0
21,2097,players_1,AlwaysCallPlayer,lost,lost_game,None,one_pair,100000,95480.0,95470.0,-10.0
21,2098,players_1,AlwaysCallPlayer,lost,lost_game,None,high_card,100000,95470.0,94760.0,-710.0
21,2099,players_1,AlwaysCallPlayer,lost,lost_game,small,one_pair,100000,94760.0,94150.0,-610.0
21,2100,players_1,AlwaysCallPlayer,lost,lost_game,big,two_pair,100000,94150.0,93840.0,-310.0
21,2001,players_2,AlwaysCallPlayer,lost,lost_game,None,one_pair,100000,100000,99790,-210
21,2002,players_2,AlwaysCallPlayer,lost,lost_game,small,one_pair,100000,99790,99780,-10
21,2003,players_2,AlwaysCallPlayer,won,won_game,big,one_pair,100000,99780,99810.0,30.0
21,2004,players_2,AlwaysCallPlayer,lost,lost_game,None,one_pair,100000,99810.0,99800.0,-10.0
21,2005,players_2,AlwaysCallPlayer,lost,lost_game,None,two_pair,100000,99800.0,99790.0,-10.0
21,2006,players_2,AlwaysCallPlayer,lost,lost_game,small,flush,100000,99790.0,99080.0,-710.0
21,2007,players_2,AlwaysCallPlayer,lost,lost_game,big,high_card,100000,99080.0,98770.0,-310.0
21,2008,players_2,AlwaysCallPlayer,won,won_game,None,one_pair,100000,98770.0,98800.0,30.0
21,2009,players_2,AlwaysCallPlayer,lost,lost_game,None,one_pair,100000,98800.0,98690.0,-110.0
21,2010,players_2,AlwaysCallPlayer,lost,lost_game,small,one_pair,100000,98690.0,98680.0,-10.0
21,2011,players_2,AlwaysCallPlayer,won,won_game,big,one_pair,100000,98680.0,98710.0,30.0
21,2012,players_2,AlwaysCallPlayer,lost,lost_game,None,one_pair,100000,98710.0,98400.0,-310.0
21,2013,players_2,AlwaysCallPlayer,won,won_game,None,three_of_kind,100000,98400.0,98430.0,30.0
21,2014,players_2,AlwaysCallPlayer,lost,lost_game,small,one_pair,100000,98430.0,98420.0,-10.0
21,2015,players_2,AlwaysCallPlayer,lost,lost_game,big,one_pair,100000,98420.0,98210.0,-210.0
21,2016,players_2,AlwaysCallPlayer,won,won_game,None,two_pair,100000,98210.0,98240.0,30.0
21,2017,players_2,AlwaysCallPlayer,lost,lost_game,None,one_pair,100000,98240.0,98230.0,-10.0
21,2018,players_2,AlwaysCallPlayer,lost,lost_game,small,one_pair,100000,98230.0,98220.0,-10.0
21,2019,players_2,AlwaysCallPlayer,lost,lost_game,big,one_pair,100000,98220.0,98210.0,-10.0
21,2020,players_2,AlwaysCallPlayer,lost,lost_game,None,one_pair,100000,98210.0,98000.0,-210.0
21,2021,players_2,AlwaysCallPlayer,lost,lost_game,None,one_pair,100000,98000.0,97990.0,-10.0
21,2022,players_2,AlwaysCallPlayer,won,won_game,small,two_pair,100000,97990.0,98020.0,30.0
21,2023,players_2,AlwaysCallPlayer,lost,lost_game,big,high_card,100000,98020.0,98010.0,-10.0
21,2024,players_2,AlwaysCallPlayer,lost,lost_game,None,two_pair,100000,98010.0,98000.0,-10.0
21,2025,players_2,AlwaysCallPlayer,won,won_game,None,straight,100000,98000.0,98630.0,630.0
21,2026,players_2,AlwaysCallPlayer,lost,lost_game,small,one_pair,100000,98630.0,98620.0,-10.0
21,2027,players_2,AlwaysCallPlayer,lost,lost_game,big,one_pair,100000,98620.0,98610.0,-10.0
21,2028,players_2,AlwaysCallPlayer,lost,lost_game,None,high_card,100000,98610.0,98600.0,-10.0
21,2029,players_2,AlwaysCallPlayer,lost,lost_game,None,one_pair,100000,98600.0,98590.0,-10.0
21,2030,players_2,AlwaysCallPlayer,lost,lost_game,small,one_pair,100000,98590.0,98580.0,-10.0
21,2031,players_2,AlwaysCallPlayer,won,won_game,big,four_of_kind,100000,98580.0,98610.0,30.0
21,2032,players_2,AlwaysCallPlayer,lost,lost_game,None,two_pair,100000,98610.0,98500.0,-110.0
21,2033,players_2,AlwaysCallPlayer,lost,lost_game,None,two_pair,100000,98500.0,98490.0,-10.0
21,2034,players_2,AlwaysCallPlayer,won,won_game,small,two_pair,100000,98490.0,98820.0,330.0
21,2035,players_2,AlwaysCallPlayer,lost,lost_game,big,one_pair,100000,98820.0,98210.0,-610.0
21,2036,players_2,AlwaysCallPlayer,lost,lost_game,None,high_card,100000,98210.0,98200.0,-10.0
21,2037,players_2,AlwaysCallPlayer,lost,lost_game,None,one_pair,100000,98200.0,98190.0,-10.0
21,2038,players_2,AlwaysCallPlayer,lost,lost_game,small,one_pair,100000,98190.0,98180.0,-10.0
21,2039,players_2,AlwaysCallPlayer,lost,lost_game,big,high_card,100000,98180.0,98170.0,-10.0
21,2040,players_2,AlwaysCallPlayer,lost,lost_game,None,one_pair,100000,98170.0,98060.0,-110.0
21,2041,players_2,AlwaysCallPlayer,lost,lost_game,None,one_pair,100000,98060.0,98050.0,-10.0
21,2042,players_2,AlwaysCallPlayer,lost,lost_game,small,two_pair,100000,98050.0,97840.0,-210.0
21,2043,players_2,AlwaysCallPlayer,lost,lost_game,big,one_pair,100000,97840.0,97830.0,-10.0
21,2044,players_2,AlwaysCallPlayer,won,won_game,None,flush,100000,97830.0,97860.0,30.0
21,2045,players_2,AlwaysCallPlayer,lost,lost_game,None,one_pair,100000,97860.0,97450.0,-410.0
21,2046,players_2,AlwaysCallPlayer,lost,lost_game,small,three_of_kind,100000,97450.0,97440.0,-10.0
21,2047,players_2,AlwaysCallPlayer,won,won_game,big,two_pair,100000,97440.0,97470.0,30.0
21,2048,players_2,AlwaysCallPlayer,lost,lost_game,None,two_pair,100000,97470.0,97460.0,-10.0
21,2049,players_2,AlwaysCallPlayer,won,won_game,None,two_pair,100000,97460.0,97490.0,30.0
21,2050,players_2,AlwaysCallPlayer,lost,lost_game,small,high_card,100000,97490.0,97480.0,-10.0
21,2051,players_2,AlwaysCallPlayer,won,won_game,big,one_pair,100000,97480.0,97510.0,30.0
21,2052,players_2,AlwaysCallPlayer,lost,lost_game,None,one_pair,100000,97510.0,97200.0,-310.0
21,2053,players_2,AlwaysCallPlayer,lost,lost_game,None,flush,100000,97200.0,96590.0,-610.0
21,2054,players_2,AlwaysCallPlayer,won,won_game,small,straight,100000,96590.0,96620.0,30.0
21,2055,players_2,AlwaysCallPlayer,won,won_game,big,straight,100000,96620.0,99050.0,2430.0
21,2056,players_2,AlwaysCallPlayer,won,won_game,None,two_pair,100000,99050.0,99080.0,30.0
21,2057,players_2,AlwaysCallPlayer,lost,lost_game,None,one_pair,100000,99080.0,98470.0,-610.0
21,2058,players_2,AlwaysCallPlayer,won,won_game,small,two_pair,100000,98470.0,98500.0,30.0
21,2059,players_2,AlwaysCallPlayer,lost,lost_game,big,two_pair,100000,98500.0,98090.0,-410.0
21,2060,players_2,AlwaysCallPlayer,lost,lost_game,None,one_pair,100000,98090.0,98080.0,-10.0
21,2061,players_2,AlwaysCallPlayer,lost,lost_game,None,two_pair,100000,98080.0,97270.0,-810.0
21,2062,players_2,AlwaysCallPlayer,lost,lost_game,small,one_pair,100000,97270.0,97260.0,-10.0
21,2063,players_2,AlwaysCallPlayer,lost,lost_game,big,two_pair,100000,97260.0,97250.0,-10.0
21,2064,players_2,AlwaysCallPlayer,lost,lost_game,None,one_pair,100000,97250.0,97040.0,-210.0
21,2065,players_2,AlwaysCallPlayer,lost,lost_game,None,one_pair,100000,97040.0,96430.0,-610.0
21,2066,players_2,AlwaysCallPlayer,won,won_game,small,three_of_kind,100000,96430.0,96460.0,30.0
21,2067,players_2,AlwaysCallPlayer,lost,lost_game,big,high_card,100000,96460.0,96450.0,-10.0
21,2068,players_2,AlwaysCallPlayer,lost,lost_game,None,one_pair,100000,96450.0,96440.0,-10.0
21,2069,players_2,AlwaysCallPlayer,lost,lost_game,None,high_card,100000,96440.0,96430.0,-10.0
21,2070,players_2,AlwaysCallPlayer,lost,lost_game,small,two_pair,100000,96430.0,96420.0,-10.0
21,2071,players_2,AlwaysCallPlayer,lost,lost_game,big,full_house,100000,96420.0,96410.0,-10.0
21,2072,players_2,AlwaysCallPlayer,lost,lost_game,None,two_pair,100000,96410.0,96400.0,-10.0
21,2073,players_2,AlwaysCallPlayer,lost,lost_game,None,high_card,100000,96400.0,96390.0,-10.0
21,2074,players_2,AlwaysCallPlayer,lost,lost_game,small,two_pair,100000,96390.0,96380.0,-10.0
21,2075,players_2,AlwaysCallPlayer,won,won_game,big,two_pair,100000,96380.0,96410.0,30.0
21,2076,players_2,AlwaysCallPlayer,lost,lost_game,None,two_pair,100000,96410.0,96400.0,-10.0
21,2077,players_2,AlwaysCallPlayer,lost,lost_game,None,high_card,100000,96400.0,95590.0,-810.0
21,2078,players_2,AlwaysCallPlayer,lost,lost_game,small,one_pair,100000,95590.0,95180.0,-410.0
21,2079,players_2,AlwaysCallPlayer,won,won_game,big,straight,100000,95180.0,95210.0,30.0
21,2080,players_2,AlwaysCallPlayer,lost,lost_game,None,two_pair,100000,95210.0,95000.0,-210.0
21,2081,players_2,AlwaysCallPlayer,lost,lost_game,None,one_pair,100000,95000.0,94990.0,-10.0
21,2082,players_2,AlwaysCallPlayer,lost,lost_game,small,one_pair,100000,94990.0,94980.0,-10.0
21,2083,players_2,AlwaysCallPlayer,lost,lost_game,big,one_pair,100000,94980.0,94970.0,-10.0
21,2084,players_2,AlwaysCallPlayer,lost,lost_game,None,one_pair,100000,94970.0,94960.0,-10.0
21,2085,players_2,AlwaysCallPlayer,won,won_game,None,two_pair,100000,94960.0,94990.0,30.0
21,2086,players_2,AlwaysCallPlayer,won,won_game,small,full_house,100000,94990.0,95700.0,710.0
21,2087,players_2,AlwaysCallPlayer,lost,lost_game,big,two_pair,100000,95700.0,95690.0,-10.0
21,2088,players_2,AlwaysCallPlayer,lost,lost_game,None,one_pair,100000,95690.0,95280.0,-410.0
21,2089,players_2,AlwaysCallPlayer,won,won_game,None,three_of_kind,100000,95280.0,95890.0,610.0
21,2090,players_2,AlwaysCallPlayer,won,won_game,small,one_pair,100000,95890.0,95920.0,30.0
21,2091,players_2,AlwaysCallPlayer,lost,lost_game,big,one_pair,100000,95920.0,95910.0,-10.0
21,2092,players_2,AlwaysCallPlayer,lost,lost_game,None,one_pair,100000,95910.0,95900.0,-10.0
21,2093,players_2,AlwaysCallPlayer,lost,lost_game,None,two_pair,100000,95900.0,95890.0,-10.0
21,2094,players_2,AlwaysCallPlayer,lost,lost_game,small,one_pair,100000,95890.0,95880.0,-10.0
21,2095,players_2,AlwaysCallPlayer,lost,lost_game,big,one_pair,100000,95880.0,95870.0,-10.0
21,2096,players_2,AlwaysCallPlayer,lost,lost_game,None,one_pair,100000,95870.0,95760.0,-110.0
21,2097,players_2,AlwaysCallPlayer,lost,lost_game,None,two_pair,100000,95760.0,95750.0,-10.0
21,2098,players_2,AlwaysCallPlayer,lost,lost_game,small,one_pair,100000,95750.0,95040.0,-710.0
21,2099,players_2,AlwaysCallPlayer,lost,lost_game,big,one_pair,100000,95040.0,94430.0,-610.0
21,2100,players_2,AlwaysCallPlayer,lost,lost_game,None,two_pair,100000,94430.0,94120.0,-310.0
21,2001,players_3,AlwaysCallPlayer,lost,lost_game,small,one_pair,100000,100000,99790,-210
21,2002,players_3,AlwaysCallPlayer,lost,lost_game,big,one_pair,100000,99790,99780,-10
21,2003,players_3,AlwaysCallPlayer,lost,lost_game,None,one_pair,100000,99780,99770,-10
21,2004,players_3,AlwaysCallPlayer,lost,lost_game,None,one_pair,100000,99770,99760,-10
21,2005,players_3,AlwaysCallPlayer,won,won_game,small,two_pair,100000,99760,99790.0,30.0
21,2006,players_3,AlwaysCallPlayer,lost,lost_game,big,one_pair,100000,99790.0,99080.0,-710.0
21,2007,players_3,AlwaysCallPlayer,won,won_game,None,one_pair,100000,99080.0,100010.0,930.0
21,2008,players_3,AlwaysCallPlayer,lost,lost_game,None,one_pair,100000,100010.0,100000.0,-10.0
21,2009,players_3,AlwaysCallPlayer,lost,lost_game,small,one_pair,100000,100000.0,99890.0,-110.0
21,2010,players_3,AlwaysCallPlayer,won,won_game,big,two_pair,100000,99890.0,99920.0,30.0
21,2011,players_3,AlwaysCallPlayer,lost,lost_game,None,one_pair,100000,99920.0,99910.0,-10.0
21,2012,players_3,AlwaysCallPlayer,lost,lost_game,None,high_card,100000,99910.0,99600.0,-310.0
21,2013,players_3,AlwaysCallPlayer,lost,lost_game,small,two_pair,100000,99600.0,99590.0,-10.0
21,2014,players_3,AlwaysCallPlayer,lost,lost_game,big,two_pair,100000,99590.0,99580.0,-10.0
21,2015,players_3,AlwaysCallPlayer,won,won_game,None,one_pair,100000,99580.0,100210.0,630.0
21,2016,players_3,AlwaysCallPlayer,lost,lost_game,None,one_pair,100000,100210.0,100200.0,-10.0
21,2017,players_3,AlwaysCallPlayer,won,won_game,small,three_of_kind,100000,100200.0,100230.0,30.0
21,2018,players_3,AlwaysCallPlayer,won,won_game,big,one_pair,100000,100230.0,100260.0,30.0
21,2019,players_3,AlwaysCallPlayer,lost,lost_game,None,one_pair,100000,100260.0,100250.0,-10.0
21,2020,players_3,AlwaysCallPlayer,lost,lost_game,None,one_pair,100000,100250.0,100040.0,-210.0
21,2021,players_3,AlwaysCallPlayer,won,won_game,small,one_pair,100000,100040.0,100070.0,30.0
21,2022,players_3,AlwaysCallPlayer,lost,lost_game,big,one_pair,100000,100070.0,100060.0,-10.0
21,2023,players_3,AlwaysCallPlayer,won,won_game,None,three_of_kind,100000,100060.0,100090.0,30.0
21,2024,players_3,AlwaysCallPlayer,lost,lost_game,None,one_pair,100000,100090.0,100080.0,-10.0
21,2025,players_3,AlwaysCallPlayer,lost,lost_game,small,one_pair,100000,100080.0,99870.0,-210.0
21,2026,players_3,AlwaysCallPlayer,won,won_game,big,three_of_kind,100000,99870.0,99900.0,30.0
21,2027,players_3,AlwaysCallPlayer,lost,lost_game,None,one_pair,100000,99900.0,99890.0,-10.0
21,2028,players_3,AlwaysCallPlayer,lost,lost_game,None,high_card,100000,99890.0,99880.0,-10.0
21,2029,players_3,AlwaysCallPlayer,won,won_game,small,two_pair,100000,99880.0,99910.0,30.0
21,2030,players_3,AlwaysCallPlayer,lost,lost_game,big,one_pair,100000,99910.0,99900.0,-10.0
21,2031,players_3,AlwaysCallPlayer,lost,lost_game,None,three_of_kind,100000,99900.0,99890.0,-10.0
21,2032,players_3,AlwaysCallPlayer,lost,lost_game,None,one_pair,100000,99890.0,99780.0,-110.0
21,2033,players_3,AlwaysCallPlayer,lost,lost_game,small,one_pair,100000,99780.0,99770.0,-10.0
21,2034,players_3,AlwaysCallPlayer,lost,lost_game,big,one_pair,100000,99770.0,99660.0,-110.0
21,2035,players_3,AlwaysCallPlayer,lost,lost_game,None,one_pair,100000,99660.0,99050.0,-610.0
21,2036,players_3,AlwaysCallPlayer,won,won_game,None,two_pair,100000,99050.0,99080.0,30.0
21,2037,players_3,AlwaysCallPlayer,lost,lost_game,small,high_card,100000,99080.0,99070.0,-10.0
21,2038,players_3,AlwaysCallPlayer,won,won_game,big,one_pair,100000,99070.0,99100.0,30.0
21,2039,players_3,AlwaysCallPlayer,won,won_game,None,one_pair,100000,99100.0,99130.0,30.0
21,2040,players_3,AlwaysCallPlayer,lost,lost_game,None,one_pair,100000,99130.0,99020.0,-110.0
21,2041,players_3,AlwaysCallPlayer,lost,lost_game,small,one_pair,100000,99020.0,99010.0,-10.0
21,2042,players_3,AlwaysCallPlayer,won,won_game,big,two_pair,100000,99010.0,99640.0,630.0
21,2043,players_3,AlwaysCallPlayer,lost,lost_game,None,one_pair,100000,99640.0,99630.0,-10.0
21,2044,players_3,AlwaysCallPlayer,lost,lost_game,None,one_pair,100000,99630.0,99620.0,-10.0
21,2045,players_3,AlwaysCallPlayer,lost,lost_game,small,one_pair,100000,99620.0,99210.0,-410.0
21,2046,players_3,AlwaysCallPlayer,lost,lost_game,big,three_of_kind,100000,99210.0,99200.0,-10.0
21,2047,players_3,AlwaysCallPlayer,lost,lost_game,None,one_pair,100000,99200.0,99190.0,-10.0
21,2048,players_3,AlwaysCallPlayer,lost,lost_game,None,one_pair,100000,99190.0,99180.0,-10.0
21,2049,players_3,AlwaysCallPlayer,lost,lost_game,small,high_card,100000,99180.0,99170.0,-10.0
21,2050,players_3,AlwaysCallPlayer,lost,lost_game,big,high_card,100000,99170.0,99160.0,-10.0
21,2051,players_3,AlwaysCallPlayer,lost,lost_game,None,high_card,100000,99160.0,99150.0,-10.0
21,2052,players_3,AlwaysCallPlayer,lost,lost_game,None,one_pair,100000,99150.0,98840.0,-310.0
21,2053,players_3,AlwaysCallPlayer,lost,lost_game,small,flush,100000,98840.0,98230.0,-610.0
21,2054,players_3,AlwaysCallPlayer,lost,lost_game,big,two_pair,100000,98230.0,98220.0,-10.0
21,2055,players_3,AlwaysCallPlayer,lost,lost_game,None,high_card,100000,98220.0,97410.0,-810.0
21,2056,players_3,AlwaysCallPlayer,lost,lost_game,None,one_pair,100000,97410.0,97400.0,-10.0
21,2057,players_3,AlwaysCallPlayer,lost,lost_game,small,two_pair,100000,97400.0,96790.0,-610.0
21,2058,players_3,AlwaysCallPlayer,lost,lost_game,big,high_card,100000,96790.0,96780.0,-10.0
21,2059,players_3,AlwaysCallPlayer,lost,lost_game,None,one_pair,100000,96780.0,96370.0,-410.0
21,2060,players_3,AlwaysCallPlayer,lost,lost_game,None,one_pair,100000,96370.0,96360.0,-10.0
21,2061,players_3,AlwaysCallPlayer,lost,lost_game,small,flush,100000,96360.0,95550.0,-810.0
21,2062,players_3,AlwaysCallPlayer,won,won_game,big,one_pair,100000,95550.0,95580.0,30.0
21,2063,players_3,AlwaysCallPlayer,won,won_game,None,two_pair,100000,95580.0,95610.0,30.0
21,2064,players_3,AlwaysCallPlayer,lost,lost_game,None,one_pair,100000,95610.0,95400.0,-210.0
21,2065,players_3,AlwaysCallPlayer,lost,lost_game,small,one_pair,100000,95400.0,94790.0,-610.0
21,2066,players_3,AlwaysCallPlayer,lost,lost_game,big,one_pair,100000,94790.0,94780.0,-10.0
21,2067,players_3,AlwaysCallPlayer,won,won_game,None,high_card,100000,94780.0,94810.0,30.0
21,2068,players_3,AlwaysCallPlayer,lost,lost_game,None,high_card,100000,94810.0,94800.0,-10.0
21,2069,players_3,AlwaysCallPlayer,won,won_game,small,two_pair,100000,94800.0,94830.0,30.0
21,2070,players_3,AlwaysCallPlayer,lost,lost_game,big,two_pair,100000,94830.0,94820.0,-10.0
21,2071,players_3,AlwaysCallPlayer,lost,lost_game,None,full_house,100000,94820.0,94810.0,-10.0
21,2072,players_3,AlwaysCallPlayer,lost,lost_game,None,two_pair,100000,94810.0,94800.0,-10.0
21,2073,players_3,AlwaysCallPlayer,lost,lost_game,small,high_card,100000,94800.0,94790.0,-10.0
21,2074,players_3,AlwaysCallPlayer,won,won_game,big,full_house,100000,94790.0,94820.0,30.0
21,2075,players_3,AlwaysCallPlayer,lost,lost_game,None,one_pair,100000,94820.0,94810.0,-10.0
21,2076,players_3,AlwaysCallPlayer,lost,lost_game,None,two_pair,100000,94810.0,94800.0,-10.0
21,2077,players_3,AlwaysCallPlayer,lost,lost_game,small,one_pair,100000,94800.0,93990.0,-810.0
21,2078,players_3,AlwaysCallPlayer,lost,lost_game,big,one_pair,100000,93990.0,93580.0,-410.0
21,2079,players_3,AlwaysCallPlayer,lost,lost_game,None,two_pair,100000,93580.0,93570.0,-10.0
21,2080,players_3,AlwaysCallPlayer,won,won_game,None,three_of_kind,100000,93570.0,94200.0,630.0
21,2081,players_3,AlwaysCallPlayer,won,won_game,small,two_pair,100000,94200.0,94230.0,30.0
21,2082,players_3,AlwaysCallPlayer,lost,lost_game,big,two_pair,100000,94230.0,94220.0,-10.0
21,2083,players_3,AlwaysCallPlayer,lost,lost_game,None,high_card,100000,94220.0,94210.0,-10.0
21,2084,players_3,AlwaysCallPlayer,won,won_game,None,three_of_kind,100000,94210.0,94240.0,30.0
21,2085,players_3,AlwaysCallPlayer,lost,lost_game,small,two_pair,100000,94240.0,94230.0,-10.0
21,2086,players_3,AlwaysCallPlayer,won,won_game,big,full_house,100000,94230.0,94940.0,710.0
21,2087,players_3,AlwaysCallPlayer,won,won_game,None,straight,100000,94940.0,94970.0,30.0
21,2088,players_3,AlwaysCallPlayer,lost,lost_game,None,one_pair,100000,94970.0,94560.0,-410.0
21,2089,players_3,AlwaysCallPlayer,lost,lost_game,small,two_pair,100000,94560.0,93950.0,-610.0
21,2090,players_3,AlwaysCallPlayer,lost,lost_game,big,high_card,100000,93950.0,93940.0,-10.0
21,2091,players_3,AlwaysCallPlayer,won,won_game,None,one_pair,100000,93940.0,93970.0,30.0
21,2092,players_3,AlwaysCallPlayer,won,won_game,None,one_pair,100000,93970.0,94000.0,30.0
21,2093,players_3,AlwaysCallPlayer,won,won_game,small,flush,100000,94000.0,94030.0,30.0
21,2094,players_3,AlwaysCallPlayer,won,won_game,big,two_pair,100000,94030.0,94060.0,30.0
21,2095,players_3,AlwaysCallPlayer,lost,lost_game,None,one_pair,100000,94060.0,94050.0,-10.0
21,2096,players_3,AlwaysCallPlayer,won,won_game,None,three_of_kind,100000,94050.0,94380.0,330.0
21,2097,players_3,AlwaysCallPlayer,won,won_game,small,two_pair,100000,94380.0,94410.0,30.0
21,2098,players_3,AlwaysCallPlayer,lost,lost_game,big,high_card,100000,94410.0,93700.0,-710.0
21,2099,players_3,AlwaysCallPlayer,lost,lost_game,None,one_pair,100000,93700.0,93090.0,-610.0
21,2100,players_3,AlwaysCallPlayer,lost,lost_game,None,two_pair,100000,93090.0,92780.0,-310.0
21,2001,players_4,SmartPlayer,lost,fold,big,,100000,100000,99790,-210
21,2002,players_4,SmartPlayer,lost,fold,None,,100000,99790,99780,-10
21,2003,players_4,SmartPlayer,lost,fold,None,,100000,99780,99770,-10
21,2004,players_4,SmartPlayer,lost,fold,small,,100000,99770,99760,-10
21,2005,players_4,SmartPlayer,lost,fold,big,,100000,99760,99750,-10
21,2006,players_4,SmartPlayer,won,won_game,None,flush,100000,99750,101880.0,2130.0
21,2007,players_4,SmartPlayer,lost,lost_game,None,one_pair,100000,101880.0,101570.0,-310.0
21,2008,players_4,SmartPlayer,lost,fold,small,one_pair,100000,101570.0,101560.0,-10.0
21,2009,players_4,SmartPlayer,lost,fold,big,one_pair,100000,101560.0,101450.0,-110.0
21,2010,players_4,SmartPlayer,lost,fold,None,one_pair,100000,101450.0,101440.0,-10.0
21,2011,players_4,SmartPlayer,lost,fold,None,one_pair,100000,101440.0,101430.0,-10.0
21,2012,players_4,SmartPlayer,lost,lost_game,small,one_pair,100000,101430.0,101120.0,-310.0
21,2013,players_4,SmartPlayer,lost,fold,big,one_pair,100000,101120.0,101110.0,-10.0
21,2014,players_4,SmartPlayer,lost,fold,None,one_pair,100000,101110.0,101100.0,-10.0
21,2015,players_4,SmartPlayer,lost,lost_game,None,one_pair,100000,101100.0,100890.0,-210.0
21,2016,players_4,SmartPlayer,lost,fold,small,one_pair,100000,100890.0,100880.0,-10.0
21,2017,players_4,SmartPlayer,lost,fold,big,one_pair,100000,100880.0,100870.0,-10.0
21,2018,players_4,SmartPlayer,lost,fold,None,one_pair,100000,100870.0,100860.0,-10.0
21,2019,players_4,SmartPlayer,lost,fold,None,one_pair,100000,100860.0,100850.0,-10.0
21,2020,players_4,SmartPlayer,won,won_game,small,two_pair,100000,100850.0,101480.0,630.0
21,2021,players_4,SmartPlayer,lost,fold,big,two_pair,100000,101480.0,101470.0,-10.0
21,2022,players_4,SmartPlayer,lost,fold,None,two_pair,100000,101470.0,101460.0,-10.0
21,2023,players_4,SmartPlayer,lost,fold,None,two_pair,100000,101460.0,101450.0,-10.0
21,2024,players_4,SmartPlayer,lost,fold,small,two_pair,100000,101450.0,101440.0,-10.0
21,2025,players_4,SmartPlayer,lost,fold,big,two_pair,100000,101440.0,101230.0,-210.0
21,2026,players_4,SmartPlayer,lost,fold,None,two_pair,100000,101230.0,101220.0,-10.0
21,2027,players_4,SmartPlayer,lost,fold,None,two_pair,100000,101220.0,101210.0,-10.0
21,2028,players_4,SmartPlayer,lost,fold,small,two_pair,100000,101210.0,101200.0,-10.0
21,2029,players_4,SmartPlayer,lost,fold,big,two_pair,100000,101200.0,101190.0,-10.0
21,2030,players_4,SmartPlayer,lost,fold,None,two_pair,100000,101190.0,101180.0,-10.0
21,2031,players_4,SmartPlayer,lost,fold,None,two_pair,100000,101180.0,101170.0,-10.0
21,2032,players_4,SmartPlayer,lost,fold,small,two_pair,100000,101170.0,101060.0,-110.0
21,2033,players_4,SmartPlayer,lost,fold,big,two_pair,100000,101060.0,101050.0,-10.0
21,2034,players_4,SmartPlayer,lost,fold,None,two_pair,100000,101050.0,100940.0,-110.0
21,2035,players_4,SmartPlayer,won,won_game,None,one_pair,100000,100940.0,102770.0,1830.0
21,2036,players_4,SmartPlayer,lost,fold,small,one_pair,100000,102770.0,102760.0,-10.0
21,2037,players_4,SmartPlayer,lost,fold,big,one_pair,100000,102760.0,102750.0,-10.0
21,2038,players_4,SmartPlayer,lost,fold,None,one_pair,100000,102750.0,102740.0,-10.0
21,2039,players_4,SmartPlayer,lost,fold,None,one_pair,100000,102740.0,102730.0,-10.0
21,2040,players_4,SmartPlayer,lost,fold,small,one_pair,100000,102730.0,102620.0,-110.0
21,2041,players_4,SmartPlayer,lost,fold,big,one_pair,100000,102620.0,102610.0,-10.0
21,2042,players_4,SmartPlayer,lost,fold,None,one_pair,100000,102610.0,102400.0,-210.0
21,2043,players_4,SmartPlayer,lost,fold,None,one_pair,100000,102400.0,102390.0,-10.0
21,2044,players_4,SmartPlayer,lost,fold,small,one_pair,100000,102390.0,102380.0,-10.0
21,2045,players_4,SmartPlayer,won,won_game,big,two_pair,100000,102380.0,103610.0,1230.0
21,2046,players_4,SmartPlayer,lost,fold,None,two_pair,100000,103610.0,103600.0,-10.0
21,2047,players_4,SmartPlayer,lost,fold,None,two_pair,100000,103600.0,103590.0,-10.0
21,2048,players_4,SmartPlayer,lost,fold,small,two_pair,100000,103590.0,103580.0,-10.0
21,2049,players_4,SmartPlayer,lost,fold,big,two_pair,100000,103580.0,103570.0,-10.0
21,2050,players_4,SmartPlayer,lost,fold,None,two_pair,100000,103570.0,103560.0,-10.0
21,2051,players_4,SmartPlayer,lost,fold,None,two_pair,100000,103560.0,103550.0,-10.0
21,2052,players_4,SmartPlayer,won,won_game,small,straight,100000,103550.0,104480.0,930.0
21,2053,players_4,SmartPlayer,won,won_game,big,flush,100000,104480.0,106310.0,1830.0
21,2054,players_4,SmartPlayer,lost,fold,None,flush,100000,106310.0,106300.0,-10.0
21,2055,players_4,SmartPlayer,lost,lost_game,None,two_pair,100000,106300.0,105490.0,-810.0
21,2056,players_4,SmartPlayer,lost,fold,small,two_pair,100000,105490.0,105480.0,-10.0
21,2057,players_4,SmartPlayer,won,won_game,big,two_pair,100000,105480.0,107310.0,1830.0
21,2058,players_4,SmartPlayer,lost,fold,None,two_pair,100000,107310.0,107300.0,-10.0
21,2059,players_4,SmartPlayer,won,won_game,None,two_pair,100000,107300.0,108530.0,1230.0
21,2060,players_4,SmartPlayer,lost,fold,small,two_pair,100000,108530.0,108520.0,-10.0
21,2061,players_4,SmartPlayer,won,won_game,big,full_house,100000,108520.0,110950.0,2430.0
21,2062,players_4,SmartPlayer,lost,fold,None,full_house,100000,110950.0,110940.0,-10.0
21,2063,players_4,SmartPlayer,lost,fold,None,full_house,100000,110940.0,110930.0,-10.0
21,2064,players_4,SmartPlayer,won,won_game,small,straight,100000,110930.0,111560.0,630.0
21,2065,players_4,SmartPlayer,won,won_game,big,one_pair,100000,111560.0,113390.0,1830.0
21,2066,players_4,SmartPlayer,lost,lost_game,None,two_pair,100000,113390.0,113380.0,-10.0
21,2067,players_4,SmartPlayer,lost,fold,None,two_pair,100000,113380.0,113370.0,-10.0
21,2068,players_4,SmartPlayer,lost,fold,small,two_pair,100000,113370.0,113360.0,-10.0
21,2069,players_4,SmartPlayer,lost,fold,big,two_pair,100000,113360.0,113350.0,-10.0
21,2070,players_4,SmartPlayer,lost,fold,None,two_pair,100000,113350.0,113340.0,-10.0
21,2071,players_4,SmartPlayer,lost,fold,None,two_pair,100000,113340.0,113330.0,-10.0
21,2072,players_4,SmartPlayer,lost,fold,small,two_pair,100000,113330.0,113320.0,-10.0
21,2073,players_4,SmartPlayer,lost,fold,big,two_pair,100000,113320.0,113310.0,-10.0
21,2074,players_4,SmartPlayer,lost,fold,None,two_pair,100000,113310.0,113300.0,-10.0
21,2075,players_4,SmartPlayer,lost,fold,None,two_pair,100000,113300.0,113290.0,-10.0
21,2076,players_4,SmartPlayer,lost,fold,small,two_pair,100000,113290.0,113280.0,-10.0
21,2077,players_4,SmartPlayer,lost,lost_game,big,one_pair,100000,113280.0,112470.0,-810.0
21,2078,players_4,SmartPlayer,won,won_game,None,two_pair,100000,112470.0,113700.0,1230.0
21,2079,players_4,SmartPlayer,lost,fold,None,two_pair,100000,113700.0,113690.0,-10.0
21,2080,players_4,SmartPlayer,lost,lost_game,small,two_pair,100000,113690.0,113480.0,-210.0
21,2081,players_4,SmartPlayer,lost,fold,big,two_pair,100000,113480.0,113470.0,-10.0
21,2082,players_4,SmartPlayer,lost,fold,None,two_pair,100000,113470.0,113460.0,-10.0
21,2083,players_4,SmartPlayer,lost,fold,None,two_pair,100000,113460.0,113450.0,-10.0
21,2084,players_4,SmartPlayer,lost,fold,small,two_pair,100000,113450.0,113440.0,-10.0
21,2085,players_4,SmartPlayer,lost,fold,big,two_pair,100000,113440.0,113430.0,-10.0
21,2086,players_4,SmartPlayer,lost,lost_game,None,full_house,100000,113430.0,112720.0,-710.0
21,2087,players_4,SmartPlayer,lost,fold,None,full_house,100000,112720.0,112710.0,-10.0
21,2088,players_4,SmartPlayer,won,won_game,small,two_pair,100000,112710.0,113940.0,1230.0
21,2089,players_4,SmartPlayer,won,won_game,big,three_of_kind,100000,113940.0,114550.0,610.0
21,2090,players_4,SmartPlayer,lost,fold,None,three_of_kind,100000,114550.0,114540.0,-10.0
21,2091,players_4,SmartPlayer,lost,fold,None,three_of_kind,100000,114540.0,114530.0,-10.0
21,2092,players_4,SmartPlayer,lost,fold,small,three_of_kind,100000,114530.0,114520.0,-10.0
21,2093,players_4,SmartPlayer,lost,fold,big,three_of_kind,100000,114520.0,114510.0,-10.0
21,2094,players_4,SmartPlayer,lost,fold,None,three_of_kind,100000,114510.0,114500.0,-10.0
21,2095,players_4,SmartPlayer,lost,fold,None,three_of_kind,100000,114500.0,114490.0,-10.0
21,2096,players_4,SmartPlayer,lost,fold,small,three_of_kind,100000,114490.0,114380.0,-110.0
21,2097,players_4,SmartPlayer,lost,fold,big,three_of_kind,100000,114380.0,114370.0,-10.0
21,2098,players_4,SmartPlayer,won,won_game,None,three_of_kind,100000,114370.0,116500.0,2130.0
21,2099,players_4,SmartPlayer,won,won_game,None,two_pair,100000,116500.0,118330.0,1830.0
21,2100,players_4,SmartPlayer,won,won_game,small,full_house,100000,118330.0,119260.0,930.0
