table_id,game_id,player_name,player_type,game_result,game_reason,blind_type,final_hand,beginning_balance,game_start_balance,game_end_balance,game_net_change
24,2301,players_1,AlwaysCallPlayer,lost,lost_game,None,one_pair,100000,100000,99990,-10
24,2302,players_1,AlwaysCallPlayer,won,won_game,None,two_pair,100000,99990,100000.0,10.0
24,2303,players_1,AlwaysCallPlayer,lost,lost_game,small,three_of_kind,100000,100000.0,99390.0,-610.0
24,2304,players_1,AlwaysCallPlayer,won,won_game,big,two_pair,100000,99390.0,100920.0,1530.0
24,2305,players_1,AlwaysCallPlayer,won,won_game,None,three_of_kind,100000,100920.0,100950.0,30.0
24,2306,players_1,AlwaysCallPlayer,lost,lost_game,None,high_card,100000,100950.0,100340.0,-610.0
24,2307,players_1,AlwaysCallPlayer,lost,lost_game,small,two_pair,100000,100340.0,100330.0,-10.0
24,2308,players_1,AlwaysCallPlayer,lost,lost_game,big,two_pair,100000,100330.0,100120.0,-210.0
24,2309,players_1,AlwaysCallPlayer,won,won_game,None,two_pair,100000,100120.0,100150.0,30.0
24,2310,players_1,AlwaysCallPlayer,won,won_game,None,two_pair,100000,100150.0,100180.0,30.0
24,2311,players_1,AlwaysCallPlayer,won,won_game,small,one_pair,100000,100180.0,100210.0,30.0
24,2312,players_1,AlwaysCallPlayer,lost,lost_game,big,high_card,100000,100210.0,100200.0,-10.0
24,2313,players_1,AlwaysCallPlayer,lost,lost_game,None,one_pair,100000,100200.0,99990.0,-210.0
24,2314,players_1,AlwaysCallPlayer,lost,lost_game,None,two_pair,100000,99990.0,99980.0,-10.0
24,2315,players_1,AlwaysCallPlayer,lost,lost_game,small,one_pair,100000,99980.0,99870.0,-110.0
24,2316,players_1,AlwaysCallPlayer,won,won_game,big,three_of_kind,100000,99870.0,100500.0,630.0
24,2317,players_1,AlwaysCallPlayer,lost,lost_game,None,one_pair,100000,100500.0,100290.0,-210.0
24,2318,players_1,AlwaysCallPlayer,won,won_game,None,straight,100000,100290.0,100300.0,10.0
24,2319,players_1,AlwaysCallPlayer,lost,lost_game,small,two_pair,100000,100300.0,100290.0,-10.0
24,2320,players_1,AlwaysCallPlayer,lost,lost_game,big,high_card,100000,100290.0,100180.0,-110.0
24,2321,players_1,AlwaysCallPlayer,won,won_game,None,two_pair,100000,100180.0,100210.0,30.0
24,2322,players_1,AlwaysCallPlayer,lost,lost_game,None,high_card,100000,100210.0,100200.0,-10.0
24,2323,players_1,AlwaysCallPlayer,won,won_game,small,two_pair,100000,100200.0,100830.0,630.0
24,2324,players_1,AlwaysCallPlayer,lost,lost_game,big,one_pair,100000,100830.0,100520.0,-310.0
24,2325,players_1,AlwaysCallPlayer,won,won_game,None,one_pair,100000,100520.0,100850.0,330.0
24,2326,players_1,AlwaysCallPlayer,lost,lost_game,None,two_pair,100000,100850.0,100840.0,-10.0
24,2327,players_1,AlwaysCallPlayer,lost,lost_game,small,high_card,100000,100840.0,100130.0,-710.0
24,2328,players_1,AlwaysCallPlayer,lost,lost_game,big,one_pair,100000,100130.0,99920.0,-210.0
24,2329,players_1,AlwaysCallPlayer,lost,lost_game,None,one_pair,100000,99920.0,99910.0,-10.0
24,2330,players_1,AlwaysCallPlayer,won,won_game,None,two_pair,100000,99910.0,99940.0,30.0
24,2331,players_1,AlwaysCallPlayer,lost,lost_game,small,high_card,100000,99940.0,99930.0,-10.0
24,2332,players_1,AlwaysCallPlayer,lost,lost_game,big,high_card,100000,99930.0,99920.0,-10.0
24,2333,players_1,AlwaysCallPlayer,won,won_game,None,two_pair,100000,99920.0,99950.0,30.0
24,2334,players_1,AlwaysCallPlayer,won,won_game,None,two_pair,100000,99950.0,100880.0,930.0
24,2335,players_1,AlwaysCallPlayer,lost,lost_game,small,two_pair,100000,100880.0,100870.0,-10.0
24,2336,players_1,AlwaysCallPlayer,lost,lost_game,big,two_pair,100000,100870.0,100860.0,-10.0
24,2337,players_1,AlwaysCallPlayer,won,won_game,None,two_pair,100000,100860.0,100890.0,30.0
24,2338,players_1,AlwaysCallPlayer,won,won_game,None,one_pair,100000,100890.0,100920.0,30.0
24,2339,players_1,AlwaysCallPlayer,lost,lost_game,small,one_pair,100000,100920.0,100910.0,-10.0
24,2340,players_1,AlwaysCallPlayer,won,won_game,big,three_of_kind,100000,100910.0,101240.0,330.0
24,2341,players_1,AlwaysCallPlayer,lost,lost_game,None,two_pair,100000,101240.0,101130.0,-110.0
24,2342,players_1,AlwaysCallPlayer,lost,lost_game,None,one_pair,100000,101130.0,101120.0,-10.0
24,2343,players_1,AlwaysCallPlayer,won,won_game,small,one_pair,100000,101120.0,101130.0,10.0
24,2344,players_1,AlwaysCallPlayer,lost,lost_game,big,two_pair,100000,101130.0,100920.0,-210.0
24,2345,players_1,AlwaysCallPlayer,won,won_game,None,straight,100000,100920.0,102150.0,1230.0
24,2346,players_1,AlwaysCallPlayer,won,won_game,None,two_pair,100000,102150.0,103080.0,930.0
24,2347,players_1,AlwaysCallPlayer,lost,lost_game,small,one_pair,100000,103080.0,103070.0,-10.0
24,2348,players_1,AlwaysCallPlayer,lost,lost_game,big,one_pair,100000,103070.0,102860.0,-210.0
24,2349,players_1,AlwaysCallPlayer,lost,lost_game,None,high_card,100000,102860.0,102850.0,-10.0
24,2350,players_1,AlwaysCallPlayer,lost,lost_game,None,high_card,100000,102850.0,102840.0,-10.0
24,2351,players_1,AlwaysCallPlayer,lost,lost_game,small,one_pair,100000,102840.0,102630.0,-210.0
24,2352,players_1,AlwaysCallPlayer,lost,lost_game,big,one_pair,100000,102630.0,102620.0,-10.0
24,2353,players_1,AlwaysCallPlayer,lost,lost_game,None,one_pair,100000,102620.0,102610.0,-10.0
24,2354,players_1,AlwaysCallPlayer,won,won_game,None,one_pair,100000,102610.0,103840.0,1230.0
24,2355,players_1,AlwaysCallPlayer,won,won_game,small,two_pair,100000,103840.0,103870.0,30.0
24,2356,players_1,AlwaysCallPlayer,lost,lost_game,big,two_pair,100000,103870.0,103860.0,-10.0
24,2357,players_1,AlwaysCallPlayer,won,won_game,None,straight,100000,103860.0,103890.0,30.0
24,2358,players_1,AlwaysCallPlayer,lost,lost_game,None,one_pair,100000,103890.0,103180.0,-710.0
24,2359,players_1,AlwaysCallPlayer,won,won_game,small,one_pair,100000,103180.0,103210.0,30.0
24,2360,players_1,AlwaysCallPlayer,lost,lost_game,big,two_pair,100000,103210.0,103000.0,-210.0
24,2361,players_1,AlwaysCallPlayer,lost,lost_game,None,one_pair,100000,103000.0,102990.0,-10.0
24,2362,players_1,AlwaysCallPlayer,won,won_game,None,two_pair,100000,102990.0,103020.0,30.0
24,2363,players_1,AlwaysCallPlayer,lost,lost_game,small,one_pair,100000,103020.0,103010.0,-10.0
24,2364,players_1,AlwaysCallPlayer,lost,lost_game,big,two_pair,100000,103010.0,102700.0,-310.0
24,2365,players_1,AlwaysCallPlayer,lost,lost_game,None,two_pair,100000,102700.0,102090.0,-610.0
24,2366,players_1,AlwaysCallPlayer,lost,lost_game,None,one_pair,100000,102090.0,101580.0,-510.0
24,2367,players_1,AlwaysCallPlayer,won,won_game,small,three_of_kind,100000,101580.0,101610.0,30.0
24,2368,players_1,AlwaysCallPlayer,lost,lost_game,big,two_pair,100000,101610.0,101600.0,-10.0
24,2369,players_1,AlwaysCallPlayer,lost,lost_game,None,straight,100000,101600.0,101590.0,-10.0
24,2370,players_1,AlwaysCallPlayer,lost,lost_game,None,straight,100000,101590.0,100880.0,-710.0
24,2371,players_1,AlwaysCallPlayer,lost,lost_game,small,one_pair,100000,100880.0,100270.0,-610.0
24,2372,players_1,AlwaysCallPlayer,won,won_game,big,one_pair,100000,100270.0,100600.0,330.0
24,2373,players_1,AlwaysCallPlayer,lost,lost_game,None,two_pair,100000,100600.0,100590.0,-10.0
24,2374,players_1,AlwaysCallPlayer,lost,lost_game,None,two_pair,100000,100590.0,100380.0,-210.0
24,2375,players_1,AlwaysCallPlayer,lost,lost_game,small,one_pair,100000,100380.0,99770.0,-610.0
24,2376,players_1,AlwaysCallPlayer,lost,lost_game,big,one_pair,100000,99770.0,99460.0,-310.0
24,2377,players_1,AlwaysCallPlayer,lost,lost_game,None,two_pair,100000,99460.0,99050.0,-410.0
24,2378,players_1,AlwaysCallPlayer,lost,lost_game,None,one_pair,100000,99050.0,98640.0,-410.0
24,2379,players_1,AlwaysCallPlayer,lost,lost_game,small,three_of_kind,100000,98640.0,98430.0,-210.0
24,2380,players_1,AlwaysCallPlayer,lost,lost_game,big,one_pair,100000,98430.0,98420.0,-10.0
24,2381,players_1,AlwaysCallPlayer,lost,lost_game,None,one_pair,100000,98420.0,98210.0,-210.0
24,2382,players_1,AlwaysCallPlayer,lost,lost_game,None,high_card,100000,98210.0,98200.0,-10.0
24,2383,players_1,AlwaysCallPlayer,lost,lost_game,small,high_card,100000,98200.0,98190.0,-10.0
24,2384,players_1,AlwaysCallPlayer,lost,lost_game,big,two_pair,100000,98190.0,98180.0,-10.0
24,2385,players_1,AlwaysCallPlayer,lost,lost_game,None,one_pair,100000,98180.0,97770.0,-410.0
24,2386,players_1,AlwaysCallPlayer,won,won_game,None,two_pair,100000,97770.0,98100.0,330.0
24,2387,players_1,AlwaysCallPlayer,won,won_game,small,three_of_kind,100000,98100.0,99030.0,930.0
24,2388,players_1,AlwaysCallPlayer,lost,lost_game,big,one_pair,100000,99030.0,99020.0,-10.0
24,2389,players_1,AlwaysCallPlayer,lost,lost_game,None,two_pair,100000,99020.0,98810.0,-210.0
24,2390,players_1,AlwaysCallPlayer,won,won_game,None,high_card,100000,98810.0,98840.0,30.0
24,2391,players_1,AlwaysCallPlayer,lost,lost_game,small,one_pair,100000,98840.0,98430.0,-410.0
24,2392,players_1,AlwaysCallPlayer,won,won_game,big,two_pair,100000,98430.0,99360.0,930.0
24,2393,players_1,AlwaysCallPlayer,lost,lost_game,None,two_pair,100000,99360.0,98950.0,-410.0
24,2394,players_1,AlwaysCallPlayer,lost,lost_game,None,one_pair,100000,98950.0,98940.0,-10.0
24,2395,players_1,AlwaysCallPlayer,won,won_game,small,two_pair,100000,98940.0,99570.0,630.0
24,2396,players_1,AlwaysCallPlayer,lost,lost_game,big,one_pair,100000,99570.0,99560.0,-10.0
24,2397,players_1,AlwaysCallPlayer,lost,lost_game,None,high_card,100000,99560.0,99050.0,-510.0
24,2398,players_1,AlwaysCallPlayer,lost,lost_game,None,one_pair,100000,99050.0,99040.0,-10.0
24,2399,players_1,AlwaysCallPlayer,lost,lost_game,small,one_pair,100000,99040.0,98230.0,-810.0
24,2400,players_1,AlwaysCallPlayer,lost,lost_game,big,one_pair,100000,98230.0,97720.0,-510.0
24,2301,players_2,AlwaysCallPlayer,won,won_game,None,two_pair,100000,100000,100030.0,30.0
24,2302,players_2,AlwaysCallPlayer,lost,lost_game,small,two_pair,100000,100030.0,100020.0,-10.0
24,2303,players_2,AlwaysCallPlayer,won,won_game,big,flush,100000,100020.0,100630.0,610.0
24,2304,players_2,AlwaysCallPlayer,lost,lost_game,None,one_pair,100000,100630.0,100120.0,-510.0
24,2305,players_2,AlwaysCallPlayer,lost,lost_game,None,two_pair,100000,100120.0,100110.0,-10.0
24,2306,players_2,AlwaysCallPlayer,won,won_game,small,one_pair,100000,100110.0,101940.0,1830.0
24,2307,players_2,AlwaysCallPlayer,won,won_game,big,straight,100000,101940.0,101970.0,30.0
24,2308,players_2,AlwaysCallPlayer,lost,lost_game,None,two_pair,100000,101970.0,101760.0,-210.0
24,2309,players_2,AlwaysCallPlayer,lost,lost_game,None,high_card,100000,101760.0,101750.0,-10.0
24,2310,players_2,AlwaysCallPlayer,lost,lost_game,small,high_card,100000,101750.0,101740.0,-10.0
24,2311,players_2,AlwaysCallPlayer,lost,lost_game,big,high_card,100000,101740.0,101730.0,-10.0
24,2312,players_2,AlwaysCallPlayer,lost,lost_game,None,high_card,100000,101730.0,101720.0,-10.0
24,2313,players_2,AlwaysCallPlayer,lost,lost_game,None,one_pair,100000,101720.0,101510.0,-210.0
24,2314,players_2,AlwaysCallPlayer,won,won_game,small,full_house,100000,101510.0,101540.0,30.0
24,2315,players_2,AlwaysCallPlayer,lost,lost_game,big,two_pair,100000,101540.0,101430.0,-110.0
24,2316,players_2,AlwaysCallPlayer,lost,lost_game,None,one_pair,100000,101430.0,101220.0,-210.0
24,2317,players_2,AlwaysCallPlayer,lost,lost_game,None,high_card,100000,101220.0,101010.0,-210.0
24,2318,players_2,AlwaysCallPlayer,lost,lost_game,small,high_card,100000,101010.0,101000.0,-10.0
24,2319,players_2,AlwaysCallPlayer,lost,lost_game,big,one_pair,100000,101000.0,100990.0,-10.0
24,2320,players_2,AlwaysCallPlayer,lost,lost_game,None,high_card,100000,100990.0,100880.0,-110.0
24,2321,players_2,AlwaysCallPlayer,lost,lost_game,None,two_pair,100000,100880.0,100870.0,-10.0
24,2322,players_2,AlwaysCallPlayer,lost,lost_game,small,high_card,100000,100870.0,100860.0,-10.0
24,2323,players_2,AlwaysCallPlayer,lost,lost_game,big,one_pair,100000,100860.0,100650.0,-210.0
24,2324,players_2,AlwaysCallPlayer,lost,lost_game,None,one_pair,100000,100650.0,100340.0,-310.0
24,2325,players_2,AlwaysCallPlayer,lost,lost_game,None,one_pair,100000,100340.0,100230.0,-110.0
24,2326,players_2,AlwaysCallPlayer,won,won_game,small,two_pair,100000,100230.0,100260.0,30.0
24,2327,players_2,AlwaysCallPlayer,lost,lost_game,big,one_pair,100000,100260.0,99550.0,-710.0
24,2328,players_2,AlwaysCallPlayer,lost,lost_game,None,high_card,100000,99550.0,99340.0,-210.0
24,2329,players_2,AlwaysCallPlayer,won,won_game,None,three_of_kind,100000,99340.0,99370.0,30.0
24,2330,players_2,AlwaysCallPlayer,lost,lost_game,small,one_pair,100000,99370.0,99360.0,-10.0
24,2331,players_2,AlwaysCallPlayer,won,won_game,big,straight,100000,99360.0,99390.0,30.0
24,2332,players_2,AlwaysCallPlayer,lost,lost_game,None,high_card,100000,99390.0,99380.0,-10.0
24,2333,players_2,AlwaysCallPlayer,lost,lost_game,None,two_pair,100000,99380.0,99370.0,-10.0
24,2334,players_2,AlwaysCallPlayer,lost,lost_game,small,one_pair,100000,99370.0,99060.0,-310.0
24,2335,players_2,AlwaysCallPlayer,won,won_game,big,two_pair,100000,99060.0,99070.0,10.0
24,2336,players_2,AlwaysCallPlayer,lost,lost_game,None,high_card,100000,99070.0,99060.0,-10.0
24,2337,players_2,AlwaysCallPlayer,lost,lost_game,None,one_pair,100000,99060.0,99050.0,-10.0
24,2338,players_2,AlwaysCallPlayer,lost,lost_game,small,one_pair,100000,99050.0,99040.0,-10.0
24,2339,players_2,AlwaysCallPlayer,won,won_game,big,one_pair,100000,99040.0,99070.0,30.0
24,2340,players_2,AlwaysCallPlayer,lost,lost_game,None,two_pair,100000,99070.0,98960.0,-110.0
24,2341,players_2,AlwaysCallPlayer,won,won_game,None,three_of_kind,100000,98960.0,99290.0,330.0
24,2342,players_2,AlwaysCallPlayer,lost,lost_game,small,two_pair,100000,99290.0,99280.0,-10.0
24,2343,players_2,AlwaysCallPlayer,lost,lost_game,big,one_pair,100000,99280.0,99270.0,-10.0
24,2344,players_2,AlwaysCallPlayer,lost,lost_game,None,two_pair,100000,99270.0,99060.0,-210.0
24,2345,players_2,AlwaysCallPlayer,lost,lost_game,None,high_card,100000,99060.0,98650.0,-410.0
24,2346,players_2,AlwaysCallPlayer,lost,lost_game,small,one_pair,100000,98650.0,98340.0,-310.0
24,2347,players_2,AlwaysCallPlayer,won,won_game,big,one_pair,100000,98340.0,98370.0,30.0
24,2348,players_2,AlwaysCallPlayer,lost,lost_game,None,one_pair,100000,98370.0,98160.0,-210.0
24,2349,players_2,AlwaysCallPlayer,lost,lost_game,None,one_pair,100000,98160.0,98150.0,-10.0
24,2350,players_2,AlwaysCallPlayer,won,won_game,small,straight,100000,98150.0,98180.0,30.0
24,2351,players_2,AlwaysCallPlayer,lost,lost_game,big,one_pair,100000,98180.0,97970.0,-210.0
24,2352,players_2,AlwaysCallPlayer,lost,lost_game,None,one_pair,100000,97970.0,97960.0,-10.0
24,2353,players_2,AlwaysCallPlayer,lost,lost_game,None,one_pair,100000,97960.0,97950.0,-10.0
24,2354,players_2,AlwaysCallPlayer,lost,lost_game,small,high_card,100000,97950.0,97540.0,-410.0
24,2355,players_2,AlwaysCallPlayer,lost,lost_game,big,two_pair,100000,97540.0,97530.0,-10.0
24,2356,players_2,AlwaysCallPlayer,won,won_game,None,full_house,100000,97530.0,97560.0,30.0
24,2357,players_2,AlwaysCallPlayer,lost,lost_game,None,one_pair,100000,97560.0,97550.0,-10.0
24,2358,players_2,AlwaysCallPlayer,won,won_game,small,two_pair,100000,97550.0,99680.0,2130.0
24,2359,players_2,AlwaysCallPlayer,lost,lost_game,big,high_card,100000,99680.0,99670.0,-10.0
24,2360,players_2,AlwaysCallPlayer,lost,lost_game,None,full_house,100000,99670.0,99460.0,-210.0
24,2361,players_2,AlwaysCallPlayer,lost,lost_game,None,one_pair,100000,99460.0,99450.0,-10.0
24,2362,players_2,AlwaysCallPlayer,lost,lost_game,small,two_pair,100000,99450.0,99440.0,-10.0
24,2363,players_2,AlwaysCallPlayer,won,won_game,big,two_pair,100000,99440.0,99470.0,30.0
24,2364,players_2,AlwaysCallPlayer,lost,lost_game,None,one_pair,100000,99470.0,99160.0,-310.0
24,2365,players_2,AlwaysCallPlayer,lost,lost_game,None,two_pair,100000,99160.0,98550.0,-610.0
24,2366,players_2,AlwaysCallPlayer,won,won_game,small,three_of_kind,100000,98550.0,100080.0,1530.0
24,2367,players_2,AlwaysCallPlayer,lost,lost_game,big,one_pair,100000,100080.0,100070.0,-10.0
24,2368,players_2,AlwaysCallPlayer,won,won_game,None,full_house,100000,100070.0,100100.0,30.0
24,2369,players_2,AlwaysCallPlayer,lost,lost_game,None,straight,100000,100100.0,100090.0,-10.0
24,2370,players_2,AlwaysCallPlayer,lost,lost_game,small,straight,100000,100090.0,99380.0,-710.0
24,2371,players_2,AlwaysCallPlayer,lost,lost_game,big,one_pair,100000,99380.0,98770.0,-610.0
24,2372,players_2,AlwaysCallPlayer,lost,lost_game,None,one_pair,100000,98770.0,98660.0,-110.0
24,2373,players_2,AlwaysCallPlayer,won,won_game,None,two_pair,100000,98660.0,98690.0,30.0
24,2374,players_2,AlwaysCallPlayer,won,won_game,small,straight,100000,98690.0,99320.0,630.0
24,2375,players_2,AlwaysCallPlayer,lost,lost_game,big,two_pair,100000,99320.0,98710.0,-610.0
24,2376,players_2,AlwaysCallPlayer,lost,lost_game,None,high_card,100000,98710.0,98400.0,-310.0
24,2377,players_2,AlwaysCallPlayer,lost,lost_game,None,one_pair,100000,98400.0,97990.0,-410.0
24,2378,players_2,AlwaysCallPlayer,lost,lost_game,small,straight,100000,97990.0,97580.0,-410.0
24,2379,players_2,AlwaysCallPlayer,lost,lost_game,big,one_pair,100000,97580.0,97370.0,-210.0
24,2380,players_2,AlwaysCallPlayer,won,won_game,None,two_pair,100000,97370.0,97400.0,30.0
24,2381,players_2,AlwaysCallPlayer,won,won_game,None,two_pair,100000,97400.0,98030.0,630.0
24,2382,players_2,AlwaysCallPlayer,won,won_game,small,one_pair,100000,98030.0,98060.0,30.0
24,2383,players_2,AlwaysCallPlayer,lost,lost_game,big,high_card,100000,98060.0,98050.0,-10.0
24,2384,players_2,AlwaysCallPlayer,won,won_game,None,full_house,100000,98050.0,98080.0,30.0
24,2385,players_2,AlwaysCallPlayer,lost,lost_game,None,high_card,100000,98080.0,97670.0,-410.0
24,2386,players_2,AlwaysCallPlayer,lost,lost_game,small,one_pair,100000,97670.0,97560.0,-110.0
24,2387,players_2,AlwaysCallPlayer,lost,lost_game,big,one_pair,100000,97560.0,97250.0,-310.0
24,2388,players_2,AlwaysCallPlayer,lost,lost_game,None,two_pair,100000,97250.0,97240.0,-10.0
24,2389,players_2,AlwaysCallPlayer,lost,lost_game,None,two_pair,100000,97240.0,97030.0,-210.0
24,2390,players_2,AlwaysCallPlayer,lost,lost_game,small,high_card,100000,97030.0,97020.0,-10.0
24,2391,players_2,AlwaysCallPlayer,lost,lost_game,big,one_pair,100000,97020.0,96610.0,-410.0
24,2392,players_2,AlwaysCallPlayer,lost,lost_game,None,one_pair,100000,96610.0,96300.0,-310.0
24,2393,players_2,AlwaysCallPlayer,won,won_game,None,three_of_kind,100000,96300.0,97530.0,1230.0
24,2394,players_2,AlwaysCallPlayer,lost,lost_game,small,high_card,100000,97530.0,97520.0,-10.0
24,2395,players_2,AlwaysCallPlayer,lost,lost_game,big,one_pair,100000,97520.0,97310.0,-210.0
24,2396,players_2,AlwaysCallPlayer,lost,lost_game,None,one_pair,100000,97310.0,97300.0,-10.0
24,2397,players_2,AlwaysCallPlayer,lost,lost_game,None,high_card,100000,97300.0,96790.0,-510.0
24,2398,players_2,AlwaysCallPlayer,lost,lost_game,small,one_pair,100000,96790.0,96780.0,-10.0
24,2399,players_2,AlwaysCallPlayer,lost,lost_game,big,one_pair,100000,96780.0,95970.0,-810.0
24,2400,players_2,AlwaysCallPlayer,lost,lost_game,None,one_pair,100000,95970.0,95460.0,-510.0
24,2301,players_3,AlwaysCallPlayer,lost,lost_game,small,two_pair,100000,100000,99990,-10
24,2302,players_3,AlwaysCallPlayer,won,won_game,big,two_pair,100000,99990,100000.0,10.0
24,2303,players_3,AlwaysCallPlayer,lost,lost_game,None,one_pair,100000,100000.0,99390.0,-610.0
24,2304,players_3,AlwaysCallPlayer,lost,lost_game,None,one_pair,100000,99390.0,98880.0,-510.0
24,2305,players_3,AlwaysCallPlayer,lost,lost_game,small,one_pair,100000,98880.0,98870.0,-10.0
24,2306,players_3,AlwaysCallPlayer,lost,lost_game,big,high_card,100000,98870.0,98260.0,-610.0
24,2307,players_3,AlwaysCallPlayer,lost,lost_game,None,two_pair,100000,98260.0,98250.0,-10.0
24,2308,players_3,AlwaysCallPlayer,won,won_game,None,two_pair,100000,98250.0,98880.0,630.0
24,2309,players_3,AlwaysCallPlayer,lost,lost_game,small,one_pair,100000,98880.0,98870.0,-10.0
24,2310,players_3,AlwaysCallPlayer,lost,lost_game,big,one_pair,100000,98870.0,98860.0,-10.0
24,2311,players_3,AlwaysCallPlayer,lost,lost_game,None,one_pair,100000,98860.0,98850.0,-10.0
24,2312,players_3,AlwaysCallPlayer,won,won_game,None,one_pair,100000,98850.0,98880.0,30.0
24,2313,players_3,AlwaysCallPlayer,lost,lost_game,small,two_pair,100000,98880.0,98670.0,-210.0
24,2314,players_3,AlwaysCallPlayer,lost,lost_game,big,full_house,100000,98670.0,98660.0,-10.0
24,2315,players_3,AlwaysCallPlayer,won,won_game,None,flush,100000,98660.0,98990.0,330.0
24,2316,players_3,AlwaysCallPlayer,lost,lost_game,None,one_pair,100000,98990.0,98780.0,-210.0
24,2317,players_3,AlwaysCallPlayer,won,won_game,small,one_pair,100000,98780.0,99410.0,630.0
24,2318,players_3,AlwaysCallPlayer,won,won_game,big,straight,100000,99410.0,99420.0,10.0
24,2319,players_3,AlwaysCallPlayer,won,won_game,None,three_of_kind,100000,99420.0,99450.0,30.0
24,2320,players_3,AlwaysCallPlayer,won,won_game,None,two_pair,100000,99450.0,99780.0,330.0
24,2321,players_3,AlwaysCallPlayer,lost,lost_game,small,two_pair,100000,99780.0,99770.0,-10.0
24,2322,players_3,AlwaysCallPlayer,won,won_game,big,one_pair,100000,99770.0,99800.0,30.0
24,2323,players_3,AlwaysCallPlayer,lost,lost_game,None,one_pair,100000,99800.0,99590.0,-210.0
24,2324,players_3,AlwaysCallPlayer,lost,lost_game,None,one_pair,100000,99590.0,99280.0,-310.0
24,2325,players_3,AlwaysCallPlayer,lost,lost_game,small,high_card,100000,99280.0,99170.0,-110.0
24,2326,players_3,AlwaysCallPlayer,lost,lost_game,big,two_pair,100000,99170.0,99160.0,-10.0
24,2327,players_3,AlwaysCallPlayer,lost,lost_game,None,one_pair,100000,99160.0,98450.0,-710.0
24,2328,players_3,AlwaysCallPlayer,lost,lost_game,None,one_pair,100000,98450.0,98240.0,-210.0
24,2329,players_3,AlwaysCallPlayer,lost,lost_game,small,one_pair,100000,98240.0,98230.0,-10.0
24,2330,players_3,AlwaysCallPlayer,lost,lost_game,big,one_pair,100000,98230.0,98220.0,-10.0
24,2331,players_3,AlwaysCallPlayer,lost,lost_game,None,high_card,100000,98220.0,98210.0,-10.0
24,2332,players_3,AlwaysCallPlayer,won,won_game,None,one_pair,100000,98210.0,98240.0,30.0
24,2333,players_3,AlwaysCallPlayer,lost,lost_game,small,one_pair,100000,98240.0,98230.0,-10.0
24,2334,players_3,AlwaysCallPlayer,lost,lost_game,big,two_pair,100000,98230.0,97920.0,-310.0
24,2335,players_3,AlwaysCallPlayer,won,won_game,None,two_pair,100000,97920.0,97930.0,10.0
24,2336,players_3,AlwaysCallPlayer,won,won_game,None,straight,100000,97930.0,97960.0,30.0
24,2337,players_3,AlwaysCallPlayer,lost,lost_game,small,one_pair,100000,97960.0,97950.0,-10.0
24,2338,players_3,AlwaysCallPlayer,lost,lost_game,big,one_pair,100000,97950.0,97940.0,-10.0
24,2339,players_3,AlwaysCallPlayer,lost,lost_game,None,one_pair,100000,97940.0,97930.0,-10.0
24,2340,players_3,AlwaysCallPlayer,lost,lost_game,None,two_pair,100000,97930.0,97820.0,-110.0
24,2341,players_3,AlwaysCallPlayer,lost,lost_game,small,one_pair,100000,97820.0,97710.0,-110.0
24,2342,players_3,AlwaysCallPlayer,lost,lost_game,big,one_pair,100000,97710.0,97700.0,-10.0
24,2343,players_3,AlwaysCallPlayer,won,won_game,None,one_pair,100000,97700.0,97710.0,10.0
24,2344,players_3,AlwaysCallPlayer,lost,lost_game,None,two_pair,100000,97710.0,97500.0,-210.0
24,2345,players_3,AlwaysCallPlayer,lost,lost_game,small,one_pair,100000,97500.0,97090.0,-410.0
24,2346,players_3,AlwaysCallPlayer,lost,lost_game,big,one_pair,100000,97090.0,96780.0,-310.0
24,2347,players_3,AlwaysCallPlayer,lost,lost_game,None,one_pair,100000,96780.0,96770.0,-10.0
24,2348,players_3,AlwaysCallPlayer,lost,lost_game,None,high_card,100000,96770.0,96560.0,-210.0
24,2349,players_3,AlwaysCallPlayer,won,won_game,small,straight,100000,96560.0,96590.0,30.0
24,2350,players_3,AlwaysCallPlayer,lost,lost_game,big,two_pair,100000,96590.0,96580.0,-10.0
24,2351,players_3,AlwaysCallPlayer,won,won_game,None,two_pair,100000,96580.0,97210.0,630.0
24,2352,players_3,AlwaysCallPlayer,won,won_game,None,two_pair,100000,97210.0,97240.0,30.0
24,2353,players_3,AlwaysCallPlayer,won,won_game,small,one_pair,100000,97240.0,97270.0,30.0
24,2354,players_3,AlwaysCallPlayer,lost,lost_game,big,high_card,100000,97270.0,96860.0,-410.0
24,2355,players_3,AlwaysCallPlayer,lost,lost_game,None,two_pair,100000,96860.0,96850.0,-10.0
24,2356,players_3,AlwaysCallPlayer,lost,lost_game,None,two_pair,100000,96850.0,96840.0,-10.0
24,2357,players_3,AlwaysCallPlayer,lost,lost_game,small,high_card,100000,96840.0,96830.0,-10.0
24,2358,players_3,AlwaysCallPlayer,lost,lost_game,big,two_pair,100000,96830.0,96120.0,-710.0
24,2359,players_3,AlwaysCallPlayer,lost,lost_game,None,high_card,100000,96120.0,96110.0,-10.0
24,2360,players_3,AlwaysCallPlayer,lost,lost_game,None,two_pair,100000,96110.0,95900.0,-210.0
24,2361,players_3,AlwaysCallPlayer,won,won_game,small,flush,100000,95900.0,95930.0,30.0
24,2362,players_3,AlwaysCallPlayer,lost,lost_game,big,two_pair,100000,95930.0,95920.0,-10.0
24,2363,players_3,AlwaysCallPlayer,lost,lost_game,None,one_pair,100000,95920.0,95910.0,-10.0
24,2364,players_3,AlwaysCallPlayer,lost,lost_game,None,one_pair,100000,95910.0,95600.0,-310.0
24,2365,players_3,AlwaysCallPlayer,won,won_game,small,straight,100000,95600.0,97430.0,1830.0
24,2366,players_3,AlwaysCallPlayer,lost,lost_game,big,one_pair,100000,97430.0,96920.0,-510.0
24,2367,players_3,AlwaysCallPlayer,lost,lost_game,None,high_card,100000,96920.0,96910.0,-10.0
24,2368,players_3,AlwaysCallPlayer,lost,lost_game,None,two_pair,100000,96910.0,96900.0,-10.0
24,2369,players_3,AlwaysCallPlayer,won,won_game,small,straight,100000,96900.0,96930.0,30.0
24,2370,players_3,AlwaysCallPlayer,lost,lost_game,big,straight,100000,96930.0,96220.0,-710.0
24,2371,players_3,AlwaysCallPlayer,won,won_game,None,two_pair,100000,96220.0,98050.0,1830.0
24,2372,players_3,AlwaysCallPlayer,lost,lost_game,None,high_card,100000,98050.0,97940.0,-110.0
24,2373,players_3,AlwaysCallPlayer,lost,lost_game,small,one_pair,100000,97940.0,97930.0,-10.0
24,2374,players_3,AlwaysCallPlayer,lost,lost_game,big,high_card,100000,97930.0,97720.0,-210.0
24,2375,players_3,AlwaysCallPlayer,lost,lost_game,None,one_pair,100000,97720.0,97110.0,-610.0
24,2376,players_3,AlwaysCallPlayer,lost,lost_game,None,one_pair,100000,97110.0,96800.0,-310.0
24,2377,players_3,AlwaysCallPlayer,won,won_game,small,straight,100000,96800.0,98030.0,1230.0
24,2378,players_3,AlwaysCallPlayer,lost,lost_game,big,two_pair,100000,98030.0,97620.0,-410.0
24,2379,players_3,AlwaysCallPlayer,lost,lost_game,None,one_pair,100000,97620.0,97410.0,-210.0
24,2380,players_3,AlwaysCallPlayer,lost,lost_game,None,one_pair,100000,97410.0,97400.0,-10.0
24,2381,players_3,AlwaysCallPlayer,lost,lost_game,small,one_pair,100000,97400.0,97190.0,-210.0
24,2382,players_3,AlwaysCallPlayer,lost,lost_game,big,high_card,100000,97190.0,97180.0,-10.0
24,2383,players_3,AlwaysCallPlayer,won,won_game,None,one_pair,100000,97180.0,97210.0,30.0
24,2384,players_3,AlwaysCallPlayer,lost,lost_game,None,two_pair,100000,97210.0,97200.0,-10.0
24,2385,players_3,AlwaysCallPlayer,lost,lost_game,small,one_pair,100000,97200.0,96790.0,-410.0
24,2386,players_3,AlwaysCallPlayer,lost,lost_game,big,high_card,100000,96790.0,96680.0,-110.0
24,2387,players_3,AlwaysCallPlayer,lost,lost_game,None,one_pair,100000,96680.0,96370.0,-310.0
24,2388,players_3,AlwaysCallPlayer,won,won_game,None,three_of_kind,100000,96370.0,96395.0,25.0
24,2389,players_3,AlwaysCallPlayer,lost,lost_game,small,two_pair,100000,96395.0,96185.0,-210.0
24,2390,players_3,AlwaysCallPlayer,lost,lost_game,big,high_card,100000,96185.0,96175.0,-10.0
24,2391,players_3,AlwaysCallPlayer,won,won_game,None,two_pair,100000,96175.0,96585.0,410.0
24,2392,players_3,AlwaysCallPlayer,lost,lost_game,None,one_pair,100000,96585.0,96275.0,-310.0
24,2393,players_3,AlwaysCallPlayer,lost,lost_game,small,one_pair,100000,96275.0,95865.0,-410.0
24,2394,players_3,AlwaysCallPlayer,lost,lost_game,big,high_card,100000,95865.0,95855.0,-10.0
24,2395,players_3,AlwaysCallPlayer,lost,lost_game,None,high_card,100000,95855.0,95645.0,-210.0
24,2396,players_3,AlwaysCallPlayer,won,won_game,None,one_pair,100000,95645.0,95675.0,30.0
24,2397,players_3,AlwaysCallPlayer,lost,lost_game,small,one_pair,100000,95675.0,95165.0,-510.0
24,2398,players_3,AlwaysCallPlayer,won,won_game,big,two_pair,100000,95165.0,95195.0,30.0
24,2399,players_3,AlwaysCallPlayer,lost,lost_game,None,two_pair,100000,95195.0,94385.0,-810.0
24,2400,players_3,AlwaysCallPlayer,won,won_game,None,straight,100000,94385.0,95915.0,1530.0
24,2301,players_4,SmartPlayer,lost,fold,big,,100000,100000,99990,-10
24,2302,players_4,SmartPlayer,lost,fold,None,,100000,99990,99980,-10
24,2303,players_4,SmartPlayer,won,won_game,None,flush,100000,99980,100590.0,610.0
24,2304,players_4,SmartPlayer,lost,lost_game,small,one_pair,100000,100590.0,100080.0,-510.0
24,2305,players_4,SmartPlayer,lost,fold,big,one_pair,100000,100080.0,100070.0,-10.0
24,2306,players_4,SmartPlayer,lost,lost_game,None,one_pair,100000,100070.0,99460.0,-610.0
24,2307,players_4,SmartPlayer,lost,fold,None,one_pair,100000,99460.0,99450.0,-10.0
24,2308,players_4,SmartPlayer,lost,fold,small,one_pair,100000,99450.0,99240.0,-210.0
24,2309,players_4,SmartPlayer,lost,fold,big,one_pair,100000,99240.0,99230.0,-10.0
24,2310,players_4,SmartPlayer,lost,fold,None,one_pair,100000,99230.0,99220.0,-10.0
24,2311,players_4,SmartPlayer,lost,fold,None,one_pair,100000,99220.0,99210.0,-10.0
24,2312,players_4,SmartPlayer,lost,fold,small,one_pair,100000,99210.0,99200.0,-10.0
24,2313,players_4,SmartPlayer,won,won_game,big,two_pair,100000,99200.0,99830.0,630.0
24,2314,players_4,SmartPlayer,lost,fold,None,two_pair,100000,99830.0,99820.0,-10.0
24,2315,players_4,SmartPlayer,lost,fold,None,two_pair,100000,99820.0,99710.0,-110.0
24,2316,players_4,SmartPlayer,lost,lost_game,small,two_pair,100000,99710.0,99500.0,-210.0
24,2317,players_4,SmartPlayer,lost,fold,big,two_pair,100000,99500.0,99290.0,-210.0
24,2318,players_4,SmartPlayer,lost,fold,None,two_pair,100000,99290.0,99280.0,-10.0
24,2319,players_4,SmartPlayer,lost,fold,None,two_pair,100000,99280.0,99270.0,-10.0
24,2320,players_4,SmartPlayer,lost,fold,small,two_pair,100000,99270.0,99160.0,-110.0
24,2321,players_4,SmartPlayer,lost,fold,big,two_pair,100000,99160.0,99150.0,-10.0
24,2322,players_4,SmartPlayer,lost,fold,None,two_pair,100000,99150.0,99140.0,-10.0
24,2323,players_4,SmartPlayer,lost,fold,None,two_pair,100000,99140.0,98930.0,-210.0
24,2324,players_4,SmartPlayer,won,won_game,small,two_pair,100000,98930.0,99860.0,930.0
24,2325,players_4,SmartPlayer,lost,fold,big,two_pair,100000,99860.0,99750.0,-110.0
24,2326,players_4,SmartPlayer,lost,fold,None,two_pair,100000,99750.0,99740.0,-10.0
24,2327,players_4,SmartPlayer,won,won_game,None,two_pair,100000,99740.0,101870.0,2130.0
24,2328,players_4,SmartPlayer,won,won_game,small,one_pair,100000,101870.0,102500.0,630.0
24,2329,players_4,SmartPlayer,lost,fold,big,one_pair,100000,102500.0,102490.0,-10.0
24,2330,players_4,SmartPlayer,lost,fold,None,one_pair,100000,102490.0,102480.0,-10.0
24,2331,players_4,SmartPlayer,lost,fold,None,one_pair,100000,102480.0,102470.0,-10.0
24,2332,players_4,SmartPlayer,lost,fold,small,one_pair,100000,102470.0,102460.0,-10.0
24,2333,players_4,SmartPlayer,lost,fold,big,one_pair,100000,102460.0,102450.0,-10.0
24,2334,players_4,SmartPlayer,lost,fold,None,one_pair,100000,102450.0,102140.0,-310.0
24,2335,players_4,SmartPlayer,lost,fold,None,one_pair,100000,102140.0,102130.0,-10.0
24,2336,players_4,SmartPlayer,lost,fold,small,one_pair,100000,102130.0,102120.0,-10.0
24,2337,players_4,SmartPlayer,lost,fold,big,one_pair,100000,102120.0,102110.0,-10.0
24,2338,players_4,SmartPlayer,lost,fold,None,one_pair,100000,102110.0,102100.0,-10.0
24,2339,players_4,SmartPlayer,lost,fold,None,one_pair,100000,102100.0,102090.0,-10.0
24,2340,players_4,SmartPlayer,lost,fold,small,one_pair,100000,102090.0,101980.0,-110.0
24,2341,players_4,SmartPlayer,lost,lost_game,big,two_pair,100000,101980.0,101870.0,-110.0
24,2342,players_4,SmartPlayer,won,won_game,None,two_pair,100000,101870.0,101900.0,30.0
24,2343,players_4,SmartPlayer,lost,fold,None,two_pair,100000,101900.0,101890.0,-10.0
24,2344,players_4,SmartPlayer,won,won_game,small,two_pair,100000,101890.0,102520.0,630.0
24,2345,players_4,SmartPlayer,lost,lost_game,big,one_pair,100000,102520.0,102110.0,-410.0
24,2346,players_4,SmartPlayer,lost,fold,None,one_pair,100000,102110.0,101800.0,-310.0
24,2347,players_4,SmartPlayer,lost,fold,None,one_pair,100000,101800.0,101790.0,-10.0
24,2348,players_4,SmartPlayer,won,won_game,small,straight,100000,101790.0,102420.0,630.0
24,2349,players_4,SmartPlayer,lost,fold,big,straight,100000,102420.0,102410.0,-10.0
24,2350,players_4,SmartPlayer,lost,fold,None,straight,100000,102410.0,102400.0,-10.0
24,2351,players_4,SmartPlayer,lost,fold,None,straight,100000,102400.0,102190.0,-210.0
24,2352,players_4,SmartPlayer,lost,fold,small,straight,100000,102190.0,102180.0,-10.0
24,2353,players_4,SmartPlayer,lost,fold,big,straight,100000,102180.0,102170.0,-10.0
24,2354,players_4,SmartPlayer,lost,lost_game,None,one_pair,100000,102170.0,101760.0,-410.0
24,2355,players_4,SmartPlayer,lost,fold,None,one_pair,100000,101760.0,101750.0,-10.0
24,2356,players_4,SmartPlayer,lost,fold,small,one_pair,100000,101750.0,101740.0,-10.0
24,2357,players_4,SmartPlayer,lost,fold,big,one_pair,100000,101740.0,101730.0,-10.0
24,2358,players_4,SmartPlayer,lost,lost_game,None,two_pair,100000,101730.0,101020.0,-710.0
24,2359,players_4,SmartPlayer,lost,fold,None,two_pair,100000,101020.0,101010.0,-10.0
24,2360,players_4,SmartPlayer,won,won_game,small,full_house,100000,101010.0,101640.0,630.0
24,2361,players_4,SmartPlayer,lost,fold,big,full_house,100000,101640.0,101630.0,-10.0
24,2362,players_4,SmartPlayer,lost,lost_game,None,two_pair,100000,101630.0,101620.0,-10.0
24,2363,players_4,SmartPlayer,lost,fold,None,two_pair,100000,101620.0,101610.0,-10.0
24,2364,players_4,SmartPlayer,won,won_game,small,three_of_kind,100000,101610.0,102540.0,930.0
24,2365,players_4,SmartPlayer,lost,lost_game,big,three_of_kind,100000,102540.0,101930.0,-610.0
24,2366,players_4,SmartPlayer,lost,lost_game,None,two_pair,100000,101930.0,101420.0,-510.0
24,2367,players_4,SmartPlayer,lost,fold,None,two_pair,100000,101420.0,101410.0,-10.0
24,2368,players_4,SmartPlayer,lost,fold,small,two_pair,100000,101410.0,101400.0,-10.0
24,2369,players_4,SmartPlayer,lost,fold,big,two_pair,100000,101400.0,101390.0,-10.0
24,2370,players_4,SmartPlayer,won,won_game,None,straight,100000,101390.0,103520.0,2130.0
24,2371,players_4,SmartPlayer,lost,lost_game,None,one_pair,100000,103520.0,102910.0,-610.0
24,2372,players_4,SmartPlayer,lost,fold,small,one_pair,100000,102910.0,102800.0,-110.0
24,2373,players_4,SmartPlayer,lost,fold,big,one_pair,100000,102800.0,102790.0,-10.0
24,2374,players_4,SmartPlayer,lost,lost_game,None,one_pair,100000,102790.0,102580.0,-210.0
24,2375,players_4,SmartPlayer,won,won_game,None,two_pair,100000,102580.0,104410.0,1830.0
24,2376,players_4,SmartPlayer,won,won_game,small,two_pair,100000,104410.0,105340.0,930.0
24,2377,players_4,SmartPlayer,lost,fold,big,two_pair,100000,105340.0,104930.0,-410.0
24,2378,players_4,SmartPlayer,won,won_game,None,straight,100000,104930.0,106160.0,1230.0
24,2379,players_4,SmartPlayer,won,won_game,None,straight,100000,106160.0,106790.0,630.0
24,2380,players_4,SmartPlayer,lost,fold,small,straight,100000,106790.0,106780.0,-10.0
24,2381,players_4,SmartPlayer,lost,fold,big,straight,100000,106780.0,106570.0,-210.0
24,2382,players_4,SmartPlayer,lost,fold,None,straight,100000,106570.0,106560.0,-10.0
24,2383,players_4,SmartPlayer,lost,fold,None,straight,100000,106560.0,106550.0,-10.0
24,2384,players_4,SmartPlayer,lost,fold,small,straight,100000,106550.0,106540.0,-10.0
24,2385,players_4,SmartPlayer,won,won_game,big,straight,100000,106540.0,107770.0,1230.0
24,2386,players_4,SmartPlayer,lost,fold,None,straight,100000,107770.0,107660.0,-110.0
24,2387,players_4,SmartPlayer,lost,lost_game,None,two_pair,100000,107660.0,107350.0,-310.0
24,2388,players_4,SmartPlayer,lost,fold,small,two_pair,100000,107350.0,107345.0,-5.0
24,2389,players_4,SmartPlayer,won,won_game,big,full_house,100000,107345.0,107975.0,630.0
24,2390,players_4,SmartPlayer,lost,fold,None,full_house,100000,107975.0,107965.0,-10.0
24,2391,players_4,SmartPlayer,won,won_game,None,two_pair,100000,107965.0,108375.0,410.0
24,2392,players_4,SmartPlayer,lost,lost_game,small,two_pair,100000,108375.0,108065.0,-310.0
24,2393,players_4,SmartPlayer,lost,lost_game,big,two_pair,100000,108065.0,107655.0,-410.0
24,2394,players_4,SmartPlayer,won,won_game,None,one_pair,100000,107655.0,107685.0,30.0
24,2395,players_4,SmartPlayer,lost,fold,None,one_pair,100000,107685.0,107475.0,-210.0
24,2396,players_4,SmartPlayer,lost,fold,small,one_pair,100000,107475.0,107465.0,-10.0
24,2397,players_4,SmartPlayer,won,won_game,big,one_pair,100000,107465.0,108995.0,1530.0
24,2398,players_4,SmartPlayer,lost,fold,None,one_pair,100000,108995.0,108985.0,-10.0
24,2399,players_4,SmartPlayer,won,won_game,None,flush,100000,108985.0,111415.0,2430.0
24,2400,players_4,SmartPlayer,lost,lost_game,small,two_pair,100000,111415.0,110905.0,-510.0
