table_id,game_id,player_name,player_type,game_result,game_reason,blind_type,final_hand,beginning_balance,game_start_balance,game_end_balance,game_net_change
22,2101,players_1,AlwaysCallPlayer,lost,lost_game,None,one_pair,100000,100000,99990,-10
22,2102,players_1,AlwaysCallPlayer,won,won_game,None,one_pair,100000,99990,100020.0,30.0
22,2103,players_1,AlwaysCallPlayer,lost,lost_game,small,one_pair,100000,100020.0,99610.0,-410.0
22,2104,players_1,AlwaysCallPlayer,lost,lost_game,big,two_pair,100000,99610.0,99500.0,-110.0
22,2105,players_1,AlwaysCallPlayer,lost,lost_game,None,three_of_kind,100000,99500.0,99490.0,-10.0
22,2106,players_1,AlwaysCallPlayer,won,won_game,None,one_pair,100000,99490.0,99520.0,30.0
22,2107,players_1,AlwaysCallPlayer,won,won_game,small,three_of_kind,100000,99520.0,99550.0,30.0
22,2108,players_1,AlwaysCallPlayer,won,won_game,big,one_pair,100000,99550.0,99580.0,30.0
22,2109,players_1,AlwaysCallPlayer,lost,lost_game,None,two_pair,100000,99580.0,99570.0,-10.0
22,2110,players_1,AlwaysCallPlayer,won,won_game,None,one_pair,100000,99570.0,99580.0,10.0
22,2111,players_1,AlwaysCallPlayer,lost,lost_game,small,one_pair,100000,99580.0,98770.0,-810.0
22,2112,players_1,AlwaysCallPlayer,lost,lost_game,big,one_pair,100000,98770.0,98560.0,-210.0
22,2113,players_1,AlwaysCallPlayer,lost,lost_game,None,high_card,100000,98560.0,98550.0,-10.0
22,2114,players_1,AlwaysCallPlayer,lost,lost_game,None,one_pair,100000,98550.0,98540.0,-10.0
22,2115,players_1,AlwaysCallPlayer,lost,lost_game,small,one_pair,100000,98540.0,98130.0,-410.0
22,2116,players_1,AlwaysCallPlayer,lost,lost_game,big,three_of_kind,100000,98130.0,98120.0,-10.0
22,2117,players_1,AlwaysCallPlayer,lost,lost_game,None,one_pair,100000,98120.0,98110.0,-10.0
22,2118,players_1,AlwaysCallPlayer,lost,lost_game,None,high_card,100000,98110.0,98100.0,-10.0
22,2119,players_1,AlwaysCallPlayer,lost,lost_game,small,high_card,100000,98100.0,98090.0,-10.0
22,2120,players_1,AlwaysCallPlayer,lost,lost_game,big,one_pair,100000,98090.0,98080.0,-10.0
22,2121,players_1,AlwaysCallPlayer,lost,lost_game,None,two_pair,100000,98080.0,97870.0,-210.0
22,2122,players_1,AlwaysCallPlayer,lost,lost_game,None,one_pair,100000,97870.0,97860.0,-10.0
22,2123,players_1,AlwaysCallPlayer,lost,lost_game,small,one_pair,100000,97860.0,97850.0,-10.0
22,2124,players_1,AlwaysCallPlayer,lost,lost_game,big,one_pair,100000,97850.0,97640.0,-210.0
22,2125,players_1,AlwaysCallPlayer,lost,lost_game,None,one_pair,100000,97640.0,97530.0,-110.0
22,2126,players_1,AlwaysCallPlayer,lost,lost_game,None,high_card,100000,97530.0,97520.0,-10.0
22,2127,players_1,AlwaysCallPlayer,won,won_game,small,one_pair,100000,97520.0,97550.0,30.0
22,2128,players_1,AlwaysCallPlayer,won,won_game,big,flush,100000,97550.0,97560.0,10.0
22,2129,players_1,AlwaysCallPlayer,won,won_game,None,two_pair,100000,97560.0,97590.0,30.0
22,2130,players_1,AlwaysCallPlayer,won,won_game,None,one_pair,100000,97590.0,97620.0,30.0
22,2131,players_1,AlwaysCallPlayer,won,won_game,small,two_pair,100000,97620.0,97650.0,30.0
22,2132,players_1,AlwaysCallPlayer,won,won_game,big,straight,100000,97650.0,97680.0,30.0
22,2133,players_1,AlwaysCallPlayer,lost,lost_game,None,high_card,100000,97680.0,97670.0,-10.0
22,2134,players_1,AlwaysCallPlayer,lost,lost_game,None,two_pair,100000,97670.0,97160.0,-510.0
22,2135,players_1,AlwaysCallPlayer,lost,lost_game,small,one_pair,100000,97160.0,97150.0,-10.0
22,2136,players_1,AlwaysCallPlayer,lost,lost_game,big,two_pair,100000,97150.0,97140.0,-10.0
22,2137,players_1,AlwaysCallPlayer,won,won_game,None,full_house,100000,97140.0,97170.0,30.0
22,2138,players_1,AlwaysCallPlayer,won,won_game,None,two_pair,100000,97170.0,97200.0,30.0
22,2139,players_1,AlwaysCallPlayer,lost,lost_game,small,one_pair,100000,97200.0,96790.0,-410.0
22,2140,players_1,AlwaysCallPlayer,won,won_game,big,three_of_kind,100000,96790.0,96820.0,30.0
22,2141,players_1,AlwaysCallPlayer,won,won_game,None,one_pair,100000,96820.0,96850.0,30.0
22,2142,players_1,AlwaysCallPlayer,lost,lost_game,None,two_pair,100000,96850.0,96840.0,-10.0
22,2143,players_1,AlwaysCallPlayer,won,won_game,small,straight,100000,96840.0,97470.0,630.0
22,2144,players_1,AlwaysCallPlayer,lost,lost_game,big,one_pair,100000,97470.0,97260.0,-210.0
22,2145,players_1,AlwaysCallPlayer,won,won_game,None,three_of_kind,100000,97260.0,98790.0,1530.0
22,2146,players_1,AlwaysCallPlayer,won,won_game,None,two_pair,100000,98790.0,98820.0,30.0
22,2147,players_1,AlwaysCallPlayer,lost,lost_game,small,one_pair,100000,98820.0,98210.0,-610.0
22,2148,players_1,AlwaysCallPlayer,lost,lost_game,big,three_of_kind,100000,98210.0,98200.0,-10.0
22,2149,players_1,AlwaysCallPlayer,lost,lost_game,None,high_card,100000,98200.0,98190.0,-10.0
22,2150,players_1,AlwaysCallPlayer,lost,lost_game,None,two_pair,100000,98190.0,98080.0,-110.0
22,2151,players_1,AlwaysCallPlayer,lost,lost_game,small,two_pair,100000,98080.0,98070.0,-10.0
22,2152,players_1,AlwaysCallPlayer,lost,lost_game,big,one_pair,100000,98070.0,97760.0,-310.0
22,2153,players_1,AlwaysCallPlayer,won,won_game,None,three_of_kind,100000,97760.0,97790.0,30.0
22,2154,players_1,AlwaysCallPlayer,won,won_game,None,two_pair,100000,97790.0,97820.0,30.0
22,2155,players_1,AlwaysCallPlayer,lost,lost_game,small,two_pair,100000,97820.0,97810.0,-10.0
22,2156,players_1,AlwaysCallPlayer,won,won_game,big,two_pair,100000,97810.0,97840.0,30.0
22,2157,players_1,AlwaysCallPlayer,won,won_game,None,full_house,100000,97840.0,97870.0,30.0
22,2158,players_1,AlwaysCallPlayer,lost,lost_game,None,two_pair,100000,97870.0,97860.0,-10.0
22,2159,players_1,AlwaysCallPlayer,lost,lost_game,small,high_card,100000,97860.0,97550.0,-310.0
22,2160,players_1,AlwaysCallPlayer,won,won_game,big,one_pair,100000,97550.0,97580.0,30.0
22,2161,players_1,AlwaysCallPlayer,lost,lost_game,None,two_pair,100000,97580.0,96970.0,-610.0
22,2162,players_1,AlwaysCallPlayer,lost,lost_game,None,one_pair,100000,96970.0,96960.0,-10.0
22,2163,players_1,AlwaysCallPlayer,lost,lost_game,small,one_pair,100000,96960.0,96550.0,-410.0
22,2164,players_1,AlwaysCallPlayer,lost,lost_game,big,high_card,100000,96550.0,96540.0,-10.0
22,2165,players_1,AlwaysCallPlayer,lost,lost_game,None,high_card,100000,96540.0,96330.0,-210.0
22,2166,players_1,AlwaysCallPlayer,lost,lost_game,None,high_card,100000,96330.0,95920.0,-410.0
22,2167,players_1,AlwaysCallPlayer,won,won_game,small,three_of_kind,100000,95920.0,95950.0,30.0
22,2168,players_1,AlwaysCallPlayer,lost,lost_game,big,two_pair,100000,95950.0,95940.0,-10.0
22,2169,players_1,AlwaysCallPlayer,lost,lost_game,None,high_card,100000,95940.0,95930.0,-10.0
22,2170,players_1,AlwaysCallPlayer,lost,lost_game,None,high_card,100000,95930.0,95220.0,-710.0
22,2171,players_1,AlwaysCallPlayer,lost,lost_game,small,high_card,100000,95220.0,95210.0,-10.0
22,2172,players_1,AlwaysCallPlayer,lost,lost_game,big,three_of_kind,100000,95210.0,95200.0,-10.0
22,2173,players_1,AlwaysCallPlayer,won,won_game,None,two_pair,100000,95200.0,95230.0,30.0
22,2174,players_1,AlwaysCallPlayer,won,won_game,None,one_pair,100000,95230.0,96460.0,1230.0
22,2175,players_1,AlwaysCallPlayer,lost,lost_game,small,one_pair,100000,96460.0,95950.0,-510.0
22,2176,players_1,AlwaysCallPlayer,lost,lost_game,big,one_pair,100000,95950.0,95440.0,-510.0
22,2177,players_1,AlwaysCallPlayer,lost,lost_game,None,one_pair,100000,95440.0,95230.0,-210.0
22,2178,players_1,AlwaysCallPlayer,won,won_game,None,straight,100000,95230.0,95860.0,630.0
22,2179,players_1,AlwaysCallPlayer,lost,lost_game,small,high_card,100000,95860.0,95850.0,-10.0
22,2180,players_1,AlwaysCallPlayer,lost,lost_game,big,high_card,100000,95850.0,95840.0,-10.0
22,2181,players_1,AlwaysCallPlayer,lost,lost_game,None,three_of_kind,100000,95840.0,95230.0,-610.0
22,2182,players_1,AlwaysCallPlayer,lost,lost_game,None,two_pair,100000,95230.0,95220.0,-10.0
22,2183,players_1,AlwaysCallPlayer,lost,lost_game,small,high_card,100000,95220.0,94910.0,-310.0
22,2184,players_1,AlwaysCallPlayer,lost,lost_game,big,one_pair,100000,94910.0,94900.0,-10.0
22,2185,players_1,AlwaysCallPlayer,won,won_game,None,one_pair,100000,94900.0,95530.0,630.0
22,2186,players_1,AlwaysCallPlayer,won,won_game,None,straight,100000,95530.0,95540.0,10.0
22,2187,players_1,AlwaysCallPlayer,won,won_game,small,two_pair,100000,95540.0,95570.0,30.0
22,2188,players_1,AlwaysCallPlayer,won,won_game,big,flush,100000,95570.0,95600.0,30.0
22,2189,players_1,AlwaysCallPlayer,lost,lost_game,None,two_pair,100000,95600.0,95590.0,-10.0
22,2190,players_1,AlwaysCallPlayer,won,won_game,None,straight,100000,95590.0,97120.0,1530.0
22,2191,players_1,AlwaysCallPlayer,lost,lost_game,small,high_card,100000,97120.0,97110.0,-10.0
22,2192,players_1,AlwaysCallPlayer,lost,lost_game,big,high_card,100000,97110.0,96800.0,-310.0
22,2193,players_1,AlwaysCallPlayer,lost,lost_game,None,one_pair,100000,96800.0,96790.0,-10.0
22,2194,players_1,AlwaysCallPlayer,lost,lost_game,None,two_pair,100000,96790.0,96780.0,-10.0
22,2195,players_1,AlwaysCallPlayer,lost,lost_game,small,two_pair,100000,96780.0,96670.0,-110.0
22,2196,players_1,AlwaysCallPlayer,won,won_game,big,one_pair,100000,96670.0,96700.0,30.0
22,2197,players_1,AlwaysCallPlayer,lost,lost_game,None,one_pair,100000,96700.0,96090.0,-610.0
22,2198,players_1,AlwaysCallPlayer,won,won_game,None,full_house,100000,96090.0,96420.0,330.0
22,2199,players_1,AlwaysCallPlayer,won,won_game,small,two_pair,100000,96420.0,96450.0,30.0
22,2200,players_1,AlwaysCallPlayer,won,won_game,big,flush,100000,96450.0,97380.0,930.0
22,2101,players_2,AlwaysCallPlayer,lost,lost_game,None,one_pair,100000,100000,99990,-10
22,2102,players_2,AlwaysCallPlayer,lost,lost_game,small,high_card,100000,99990,99980,-10
22,2103,players_2,AlwaysCallPlayer,lost,lost_game,big,one_pair,100000,99980,99570,-410
22,2104,players_2,AlwaysCallPlayer,lost,lost_game,None,two_pair,100000,99570,99460,-110
22,2105,players_2,AlwaysCallPlayer,won,won_game,None,full_house,100000,99460,99470.0,10.0
22,2106,players_2,AlwaysCallPlayer,lost,lost_game,small,high_card,100000,99470.0,99460.0,-10.0
22,2107,players_2,AlwaysCallPlayer,lost,lost_game,big,two_pair,100000,99460.0,99450.0,-10.0
22,2108,players_2,AlwaysCallPlayer,lost,lost_game,None,one_pair,100000,99450.0,99440.0,-10.0
22,2109,players_2,AlwaysCallPlayer,won,won_game,None,two_pair,100000,99440.0,99470.0,30.0
22,2110,players_2,AlwaysCallPlayer,lost,lost_game,small,high_card,100000,99470.0,99460.0,-10.0
22,2111,players_2,AlwaysCallPlayer,lost,lost_game,big,high_card,100000,99460.0,98650.0,-810.0
22,2112,players_2,AlwaysCallPlayer,lost,lost_game,None,straight,100000,98650.0,98440.0,-210.0
22,2113,players_2,AlwaysCallPlayer,lost,lost_game,None,one_pair,100000,98440.0,98430.0,-10.0
22,2114,players_2,AlwaysCallPlayer,lost,lost_game,small,two_pair,100000,98430.0,98420.0,-10.0
22,2115,players_2,AlwaysCallPlayer,lost,lost_game,big,straight,100000,98420.0,98010.0,-410.0
22,2116,players_2,AlwaysCallPlayer,won,won_game,None,full_house,100000,98010.0,98040.0,30.0
22,2117,players_2,AlwaysCallPlayer,lost,lost_game,None,high_card,100000,98040.0,98030.0,-10.0
22,2118,players_2,AlwaysCallPlayer,lost,lost_game,small,high_card,100000,98030.0,98020.0,-10.0
22,2119,players_2,AlwaysCallPlayer,won,won_game,big,one_pair,100000,98020.0,98050.0,30.0
22,2120,players_2,AlwaysCallPlayer,won,won_game,None,two_pair,100000,98050.0,98080.0,30.0
22,2121,players_2,AlwaysCallPlayer,won,won_game,None,two_pair,100000,98080.0,98710.0,630.0
22,2122,players_2,AlwaysCallPlayer,lost,lost_game,small,high_card,100000,98710.0,98700.0,-10.0
22,2123,players_2,AlwaysCallPlayer,lost,lost_game,big,one_pair,100000,98700.0,98690.0,-10.0
22,2124,players_2,AlwaysCallPlayer,won,won_game,None,two_pair,100000,98690.0,99320.0,630.0
22,2125,players_2,AlwaysCallPlayer,won,won_game,None,two_pair,100000,99320.0,99650.0,330.0
22,2126,players_2,AlwaysCallPlayer,lost,lost_game,small,one_pair,100000,99650.0,99640.0,-10.0
22,2127,players_2,AlwaysCallPlayer,lost,lost_game,big,high_card,100000,99640.0,99630.0,-10.0
22,2128,players_2,AlwaysCallPlayer,lost,lost_game,None,two_pair,100000,99630.0,99620.0,-10.0
22,2129,players_2,AlwaysCallPlayer,lost,lost_game,None,two_pair,100000,99620.0,99610.0,-10.0
22,2130,players_2,AlwaysCallPlayer,lost,lost_game,small,one_pair,100000,99610.0,99600.0,-10.0
22,2131,players_2,AlwaysCallPlayer,lost,lost_game,big,one_pair,100000,99600.0,99590.0,-10.0
22,2132,players_2,AlwaysCallPlayer,lost,lost_game,None,high_card,100000,99590.0,99580.0,-10.0
22,2133,players_2,AlwaysCallPlayer,won,won_game,None,two_pair,100000,99580.0,99610.0,30.0
22,2134,players_2,AlwaysCallPlayer,lost,lost_game,small,two_pair,100000,99610.0,99100.0,-510.0
22,2135,players_2,AlwaysCallPlayer,lost,lost_game,big,one_pair,100000,99100.0,99090.0,-10.0
22,2136,players_2,AlwaysCallPlayer,won,won_game,None,two_pair,100000,99090.0,99120.0,30.0
22,2137,players_2,AlwaysCallPlayer,lost,lost_game,None,flush,100000,99120.0,99110.0,-10.0
22,2138,players_2,AlwaysCallPlayer,lost,lost_game,small,high_card,100000,99110.0,99100.0,-10.0
22,2139,players_2,AlwaysCallPlayer,lost,lost_game,big,two_pair,100000,99100.0,98690.0,-410.0
22,2140,players_2,AlwaysCallPlayer,lost,lost_game,None,high_card,100000,98690.0,98680.0,-10.0
22,2141,players_2,AlwaysCallPlayer,lost,lost_game,None,one_pair,100000,98680.0,98670.0,-10.0
22,2142,players_2,AlwaysCallPlayer,lost,lost_game,small,one_pair,100000,98670.0,98660.0,-10.0
22,2143,players_2,AlwaysCallPlayer,lost,lost_game,big,high_card,100000,98660.0,98450.0,-210.0
22,2144,players_2,AlwaysCallPlayer,lost,lost_game,None,two_pair,100000,98450.0,98240.0,-210.0
22,2145,players_2,AlwaysCallPlayer,lost,lost_game,None,two_pair,100000,98240.0,97730.0,-510.0
22,2146,players_2,AlwaysCallPlayer,lost,lost_game,small,one_pair,100000,97730.0,97720.0,-10.0
22,2147,players_2,AlwaysCallPlayer,won,won_game,big,straight,100000,97720.0,99550.0,1830.0
22,2148,players_2,AlwaysCallPlayer,lost,lost_game,None,three_of_kind,100000,99550.0,99540.0,-10.0
22,2149,players_2,AlwaysCallPlayer,won,won_game,None,one_pair,100000,99540.0,99570.0,30.0
22,2150,players_2,AlwaysCallPlayer,lost,lost_game,small,one_pair,100000,99570.0,99460.0,-110.0
22,2151,players_2,AlwaysCallPlayer,won,won_game,big,two_pair,100000,99460.0,99490.0,30.0
22,2152,players_2,AlwaysCallPlayer,lost,lost_game,None,two_pair,100000,99490.0,99180.0,-310.0
22,2153,players_2,AlwaysCallPlayer,lost,lost_game,None,one_pair,100000,99180.0,99170.0,-10.0
22,2154,players_2,AlwaysCallPlayer,lost,lost_game,small,one_pair,100000,99170.0,99160.0,-10.0
22,2155,players_2,AlwaysCallPlayer,lost,lost_game,big,two_pair,100000,99160.0,99150.0,-10.0
22,2156,players_2,AlwaysCallPlayer,lost,lost_game,None,two_pair,100000,99150.0,99140.0,-10.0
22,2157,players_2,AlwaysCallPlayer,lost,lost_game,None,two_pair,100000,99140.0,99130.0,-10.0
22,2158,players_2,AlwaysCallPlayer,lost,lost_game,small,one_pair,100000,99130.0,99120.0,-10.0
22,2159,players_2,AlwaysCallPlayer,won,won_game,big,two_pair,100000,99120.0,100050.0,930.0
22,2160,players_2,AlwaysCallPlayer,lost,lost_game,None,high_card,100000,100050.0,100040.0,-10.0
22,2161,players_2,AlwaysCallPlayer,lost,lost_game,None,flush,100000,100040.0,99430.0,-610.0
22,2162,players_2,AlwaysCallPlayer,won,won_game,small,straight,100000,99430.0,99460.0,30.0
22,2163,players_2,AlwaysCallPlayer,lost,lost_game,big,high_card,100000,99460.0,99050.0,-410.0
22,2164,players_2,AlwaysCallPlayer,lost,lost_game,None,one_pair,100000,99050.0,99040.0,-10.0
22,2165,players_2,AlwaysCallPlayer,lost,lost_game,None,high_card,100000,99040.0,98830.0,-210.0
22,2166,players_2,AlwaysCallPlayer,lost,lost_game,small,high_card,100000,98830.0,98420.0,-410.0
22,2167,players_2,AlwaysCallPlayer,lost,lost_game,big,one_pair,100000,98420.0,98410.0,-10.0
22,2168,players_2,AlwaysCallPlayer,lost,lost_game,None,two_pair,100000,98410.0,98400.0,-10.0
22,2169,players_2,AlwaysCallPlayer,lost,lost_game,None,high_card,100000,98400.0,98390.0,-10.0
22,2170,players_2,AlwaysCallPlayer,won,won_game,small,straight,100000,98390.0,100520.0,2130.0
22,2171,players_2,AlwaysCallPlayer,lost,lost_game,big,one_pair,100000,100520.0,100510.0,-10.0
22,2172,players_2,AlwaysCallPlayer,lost,lost_game,None,three_of_kind,100000,100510.0,100500.0,-10.0
22,2173,players_2,AlwaysCallPlayer,lost,lost_game,None,two_pair,100000,100500.0,100490.0,-10.0
22,2174,players_2,AlwaysCallPlayer,lost,lost_game,small,high_card,100000,100490.0,100080.0,-410.0
22,2175,players_2,AlwaysCallPlayer,won,won_game,big,full_house,100000,100080.0,101610.0,1530.0
22,2176,players_2,AlwaysCallPlayer,lost,lost_game,None,one_pair,100000,101610.0,101100.0,-510.0
22,2177,players_2,AlwaysCallPlayer,lost,lost_game,None,one_pair,100000,101100.0,100890.0,-210.0
22,2178,players_2,AlwaysCallPlayer,lost,lost_game,small,one_pair,100000,100890.0,100680.0,-210.0
22,2179,players_2,AlwaysCallPlayer,lost,lost_game,big,high_card,100000,100680.0,100670.0,-10.0
22,2180,players_2,AlwaysCallPlayer,won,won_game,None,one_pair,100000,100670.0,100700.0,30.0
22,2181,players_2,AlwaysCallPlayer,lost,lost_game,None,one_pair,100000,100700.0,100090.0,-610.0
22,2182,players_2,AlwaysCallPlayer,lost,lost_game,small,one_pair,100000,100090.0,100080.0,-10.0
22,2183,players_2,AlwaysCallPlayer,won,won_game,big,three_of_kind,100000,100080.0,101010.0,930.0
22,2184,players_2,AlwaysCallPlayer,won,won_game,None,two_pair,100000,101010.0,101040.0,30.0
22,2185,players_2,AlwaysCallPlayer,lost,lost_game,None,one_pair,100000,101040.0,100830.0,-210.0
22,2186,players_2,AlwaysCallPlayer,won,won_game,small,straight,100000,100830.0,100840.0,10.0
22,2187,players_2,AlwaysCallPlayer,lost,lost_game,big,one_pair,100000,100840.0,100830.0,-10.0
22,2188,players_2,AlwaysCallPlayer,lost,lost_game,None,one_pair,100000,100830.0,100820.0,-10.0
22,2189,players_2,AlwaysCallPlayer,won,won_game,None,two_pair,100000,100820.0,100850.0,30.0
22,2190,players_2,AlwaysCallPlayer,lost,lost_game,small,one_pair,100000,100850.0,100340.0,-510.0
22,2191,players_2,AlwaysCallPlayer,lost,lost_game,big,high_card,100000,100340.0,100330.0,-10.0
22,2192,players_2,AlwaysCallPlayer,lost,lost_game,None,one_pair,100000,100330.0,100020.0,-310.0
22,2193,players_2,AlwaysCallPlayer,won,won_game,None,flush,100000,100020.0,100050.0,30.0
22,2194,players_2,AlwaysCallPlayer,lost,lost_game,small,one_pair,100000,100050.0,100040.0,-10.0
22,2195,players_2,AlwaysCallPlayer,won,won_game,big,two_pair,100000,100040.0,100370.0,330.0
22,2196,players_2,AlwaysCallPlayer,lost,lost_game,None,one_pair,100000,100370.0,100360.0,-10.0
22,2197,players_2,AlwaysCallPlayer,lost,lost_game,None,one_pair,100000,100360.0,99750.0,-610.0
22,2198,players_2,AlwaysCallPlayer,lost,lost_game,small,full_house,100000,99750.0,99640.0,-110.0
22,2199,players_2,AlwaysCallPlayer,lost,lost_game,big,one_pair,100000,99640.0,99630.0,-10.0
22,2200,players_2,AlwaysCallPlayer,lost,lost_game,None,one_pair,100000,99630.0,99320.0,-310.0
22,2101,players_3,AlwaysCallPlayer,won,won_game,small,one_pair,100000,100000,100030.0,30.0
22,2102,players_3,AlwaysCallPlayer,lost,lost_game,big,high_card,100000,100030.0,100020.0,-10.0
22,2103,players_3,AlwaysCallPlayer,lost,lost_game,None,one_pair,100000,100020.0,99610.0,-410.0
22,2104,players_3,AlwaysCallPlayer,lost,lost_game,None,two_pair,100000,99610.0,99500.0,-110.0
22,2105,players_3,AlwaysCallPlayer,won,won_game,small,full_house,100000,99500.0,99510.0,10.0
22,2106,players_3,AlwaysCallPlayer,lost,lost_game,big,high_card,100000,99510.0,99500.0,-10.0
22,2107,players_3,AlwaysCallPlayer,lost,lost_game,None,one_pair,100000,99500.0,99490.0,-10.0
22,2108,players_3,AlwaysCallPlayer,lost,lost_game,None,one_pair,100000,99490.0,99480.0,-10.0
22,2109,players_3,AlwaysCallPlayer,lost,lost_game,small,two_pair,100000,99480.0,99470.0,-10.0
22,2110,players_3,AlwaysCallPlayer,won,won_game,big,one_pair,100000,99470.0,99480.0,10.0
22,2111,players_3,AlwaysCallPlayer,lost,lost_game,None,one_pair,100000,99480.0,98670.0,-810.0
22,2112,players_3,AlwaysCallPlayer,won,won_game,None,straight,100000,98670.0,99300.0,630.0
22,2113,players_3,AlwaysCallPlayer,won,won_game,small,two_pair,100000,99300.0,99330.0,30.0
22,2114,players_3,AlwaysCallPlayer,won,won_game,big,two_pair,100000,99330.0,99360.0,30.0
22,2115,players_3,AlwaysCallPlayer,won,won_game,None,flush,100000,99360.0,100590.0,1230.0
22,2116,players_3,AlwaysCallPlayer,lost,lost_game,None,three_of_kind,100000,100590.0,100580.0,-10.0
22,2117,players_3,AlwaysCallPlayer,won,won_game,small,one_pair,100000,100580.0,100610.0,30.0
22,2118,players_3,AlwaysCallPlayer,won,won_game,big,straight,100000,100610.0,100640.0,30.0
22,2119,players_3,AlwaysCallPlayer,lost,lost_game,None,high_card,100000,100640.0,100630.0,-10.0
22,2120,players_3,AlwaysCallPlayer,lost,lost_game,None,one_pair,100000,100630.0,100620.0,-10.0
22,2121,players_3,AlwaysCallPlayer,lost,lost_game,small,two_pair,100000,100620.0,100410.0,-210.0
22,2122,players_3,AlwaysCallPlayer,won,won_game,big,one_pair,100000,100410.0,100440.0,30.0
22,2123,players_3,AlwaysCallPlayer,won,won_game,None,two_pair,100000,100440.0,100470.0,30.0
22,2124,players_3,AlwaysCallPlayer,lost,lost_game,None,one_pair,100000,100470.0,100260.0,-210.0
22,2125,players_3,AlwaysCallPlayer,lost,lost_game,small,two_pair,100000,100260.0,100150.0,-110.0
22,2126,players_3,AlwaysCallPlayer,won,won_game,big,three_of_kind,100000,100150.0,100180.0,30.0
22,2127,players_3,AlwaysCallPlayer,lost,lost_game,None,high_card,100000,100180.0,100170.0,-10.0
22,2128,players_3,AlwaysCallPlayer,won,won_game,None,flush,100000,100170.0,100180.0,10.0
22,2129,players_3,AlwaysCallPlayer,lost,lost_game,small,one_pair,100000,100180.0,100170.0,-10.0
22,2130,players_3,AlwaysCallPlayer,lost,lost_game,big,high_card,100000,100170.0,100160.0,-10.0
22,2131,players_3,AlwaysCallPlayer,lost,lost_game,None,two_pair,100000,100160.0,100150.0,-10.0
22,2132,players_3,AlwaysCallPlayer,lost,lost_game,None,two_pair,100000,100150.0,100140.0,-10.0
22,2133,players_3,AlwaysCallPlayer,lost,lost_game,small,high_card,100000,100140.0,100130.0,-10.0
22,2134,players_3,AlwaysCallPlayer,lost,lost_game,big,two_pair,100000,100130.0,99620.0,-510.0
22,2135,players_3,AlwaysCallPlayer,won,won_game,None,two_pair,100000,99620.0,99650.0,30.0
22,2136,players_3,AlwaysCallPlayer,lost,lost_game,None,one_pair,100000,99650.0,99640.0,-10.0
22,2137,players_3,AlwaysCallPlayer,lost,lost_game,small,one_pair,100000,99640.0,99630.0,-10.0
22,2138,players_3,AlwaysCallPlayer,lost,lost_game,big,one_pair,100000,99630.0,99620.0,-10.0
22,2139,players_3,AlwaysCallPlayer,lost,lost_game,None,one_pair,100000,99620.0,99210.0,-410.0
22,2140,players_3,AlwaysCallPlayer,lost,lost_game,None,one_pair,100000,99210.0,99200.0,-10.0
22,2141,players_3,AlwaysCallPlayer,lost,lost_game,small,one_pair,100000,99200.0,99190.0,-10.0
22,2142,players_3,AlwaysCallPlayer,won,won_game,big,two_pair,100000,99190.0,99220.0,30.0
22,2143,players_3,AlwaysCallPlayer,lost,lost_game,None,one_pair,100000,99220.0,99010.0,-210.0
22,2144,players_3,AlwaysCallPlayer,lost,lost_game,None,two_pair,100000,99010.0,98800.0,-210.0
22,2145,players_3,AlwaysCallPlayer,lost,lost_game,small,one_pair,100000,98800.0,98290.0,-510.0
22,2146,players_3,AlwaysCallPlayer,lost,lost_game,big,two_pair,100000,98290.0,98280.0,-10.0
22,2147,players_3,AlwaysCallPlayer,lost,lost_game,None,one_pair,100000,98280.0,97670.0,-610.0
22,2148,players_3,AlwaysCallPlayer,won,won_game,None,three_of_kind,100000,97670.0,97700.0,30.0
22,2149,players_3,AlwaysCallPlayer,lost,lost_game,small,high_card,100000,97700.0,97690.0,-10.0
22,2150,players_3,AlwaysCallPlayer,won,won_game,big,two_pair,100000,97690.0,98020.0,330.0
22,2151,players_3,AlwaysCallPlayer,lost,lost_game,None,two_pair,100000,98020.0,98010.0,-10.0
22,2152,players_3,AlwaysCallPlayer,lost,lost_game,None,one_pair,100000,98010.0,97700.0,-310.0
22,2153,players_3,AlwaysCallPlayer,lost,lost_game,small,one_pair,100000,97700.0,97690.0,-10.0
22,2154,players_3,AlwaysCallPlayer,lost,lost_game,big,high_card,100000,97690.0,97680.0,-10.0
22,2155,players_3,AlwaysCallPlayer,won,won_game,None,full_house,100000,97680.0,97710.0,30.0
22,2156,players_3,AlwaysCallPlayer,lost,lost_game,None,one_pair,100000,97710.0,97700.0,-10.0
22,2157,players_3,AlwaysCallPlayer,lost,lost_game,small,straight,100000,97700.0,97690.0,-10.0
22,2158,players_3,AlwaysCallPlayer,won,won_game,big,two_pair,100000,97690.0,97720.0,30.0
22,2159,players_3,AlwaysCallPlayer,lost,lost_game,None,one_pair,100000,97720.0,97410.0,-310.0
22,2160,players_3,AlwaysCallPlayer,lost,lost_game,None,high_card,100000,97410.0,97400.0,-10.0
22,2161,players_3,AlwaysCallPlayer,lost,lost_game,small,two_pair,100000,97400.0,96790.0,-610.0
22,2162,players_3,AlwaysCallPlayer,lost,lost_game,big,one_pair,100000,96790.0,96780.0,-10.0
22,2163,players_3,AlwaysCallPlayer,lost,lost_game,None,high_card,100000,96780.0,96370.0,-410.0
22,2164,players_3,AlwaysCallPlayer,won,won_game,None,flush,100000,96370.0,96400.0,30.0
22,2165,players_3,AlwaysCallPlayer,won,won_game,small,three_of_kind,100000,96400.0,97030.0,630.0
22,2166,players_3,AlwaysCallPlayer,lost,lost_game,big,three_of_kind,100000,97030.0,96620.0,-410.0
22,2167,players_3,AlwaysCallPlayer,lost,lost_game,None,one_pair,100000,96620.0,96610.0,-10.0
22,2168,players_3,AlwaysCallPlayer,won,won_game,None,full_house,100000,96610.0,96640.0,30.0
22,2169,players_3,AlwaysCallPlayer,won,won_game,small,straight,100000,96640.0,96670.0,30.0
22,2170,players_3,AlwaysCallPlayer,lost,lost_game,big,straight,100000,96670.0,95960.0,-710.0
22,2171,players_3,AlwaysCallPlayer,won,won_game,None,one_pair,100000,95960.0,95990.0,30.0
22,2172,players_3,AlwaysCallPlayer,won,won_game,None,full_house,100000,95990.0,96020.0,30.0
22,2173,players_3,AlwaysCallPlayer,lost,lost_game,small,two_pair,100000,96020.0,96010.0,-10.0
22,2174,players_3,AlwaysCallPlayer,lost,lost_game,big,high_card,100000,96010.0,95600.0,-410.0
22,2175,players_3,AlwaysCallPlayer,lost,lost_game,None,one_pair,100000,95600.0,95090.0,-510.0
22,2176,players_3,AlwaysCallPlayer,lost,lost_game,None,two_pair,100000,95090.0,94580.0,-510.0
22,2177,players_3,AlwaysCallPlayer,won,won_game,small,two_pair,100000,94580.0,95210.0,630.0
22,2178,players_3,AlwaysCallPlayer,lost,lost_game,big,straight,100000,95210.0,95000.0,-210.0
22,2179,players_3,AlwaysCallPlayer,won,won_game,None,straight,100000,95000.0,95030.0,30.0
22,2180,players_3,AlwaysCallPlayer,lost,lost_game,None,high_card,100000,95030.0,95020.0,-10.0
22,2181,players_3,AlwaysCallPlayer,lost,lost_game,small,two_pair,100000,95020.0,94410.0,-610.0
22,2182,players_3,AlwaysCallPlayer,won,won_game,big,two_pair,100000,94410.0,94440.0,30.0
22,2183,players_3,AlwaysCallPlayer,lost,lost_game,None,one_pair,100000,94440.0,94130.0,-310.0
22,2184,players_3,AlwaysCallPlayer,lost,lost_game,None,one_pair,100000,94130.0,94120.0,-10.0
22,2185,players_3,AlwaysCallPlayer,lost,lost_game,small,one_pair,100000,94120.0,93910.0,-210.0
22,2186,players_3,AlwaysCallPlayer,lost,lost_game,big,high_card,100000,93910.0,93900.0,-10.0
22,2187,players_3,AlwaysCallPlayer,lost,lost_game,None,one_pair,100000,93900.0,93890.0,-10.0
22,2188,players_3,AlwaysCallPlayer,lost,lost_game,None,one_pair,100000,93890.0,93880.0,-10.0
22,2189,players_3,AlwaysCallPlayer,lost,lost_game,small,two_pair,100000,93880.0,93870.0,-10.0
22,2190,players_3,AlwaysCallPlayer,lost,lost_game,big,one_pair,100000,93870.0,93360.0,-510.0
22,2191,players_3,AlwaysCallPlayer,won,won_game,None,one_pair,100000,93360.0,93390.0,30.0
22,2192,players_3,AlwaysCallPlayer,lost,lost_game,None,high_card,100000,93390.0,93080.0,-310.0
22,2193,players_3,AlwaysCallPlayer,lost,lost_game,small,one_pair,100000,93080.0,93070.0,-10.0
22,2194,players_3,AlwaysCallPlayer,won,won_game,big,full_house,100000,93070.0,93100.0,30.0
22,2195,players_3,AlwaysCallPlayer,lost,lost_game,None,high_card,100000,93100.0,92990.0,-110.0
22,2196,players_3,AlwaysCallPlayer,lost,lost_game,None,one_pair,100000,92990.0,92980.0,-10.0
22,2197,players_3,AlwaysCallPlayer,won,won_game,small,flush,100000,92980.0,94810.0,1830.0
22,2198,players_3,AlwaysCallPlayer,lost,lost_game,big,three_of_kind,100000,94810.0,94700.0,-110.0
22,2199,players_3,AlwaysCallPlayer,lost,lost_game,None,one_pair,100000,94700.0,94690.0,-10.0
22,2200,players_3,AlwaysCallPlayer,lost,lost_game,None,high_card,100000,94690.0,94380.0,-310.0
22,2101,players_4,SmartPlayer,lost,fold,big,,100000,100000,99990,-10
22,2102,players_4,SmartPlayer,lost,fold,None,,100000,99990,99980,-10
22,2103,players_4,SmartPlayer,won,won_game,None,one_pair,100000,99980,101210.0,1230.0
22,2104,players_4,SmartPlayer,won,won_game,small,full_house,100000,101210.0,101540.0,330.0
22,2105,players_4,SmartPlayer,lost,fold,big,full_house,100000,101540.0,101530.0,-10.0
22,2106,players_4,SmartPlayer,lost,fold,None,full_house,100000,101530.0,101520.0,-10.0
22,2107,players_4,SmartPlayer,lost,fold,None,full_house,100000,101520.0,101510.0,-10.0
22,2108,players_4,SmartPlayer,lost,fold,small,full_house,100000,101510.0,101500.0,-10.0
22,2109,players_4,SmartPlayer,lost,fold,big,full_house,100000,101500.0,101490.0,-10.0
22,2110,players_4,SmartPlayer,lost,fold,None,full_house,100000,101490.0,101480.0,-10.0
22,2111,players_4,SmartPlayer,won,won_game,None,one_pair,100000,101480.0,103910.0,2430.0
22,2112,players_4,SmartPlayer,lost,fold,small,one_pair,100000,103910.0,103700.0,-210.0
22,2113,players_4,SmartPlayer,lost,fold,big,one_pair,100000,103700.0,103690.0,-10.0
22,2114,players_4,SmartPlayer,lost,fold,None,one_pair,100000,103690.0,103680.0,-10.0
22,2115,players_4,SmartPlayer,lost,lost_game,None,one_pair,100000,103680.0,103270.0,-410.0
22,2116,players_4,SmartPlayer,lost,fold,small,one_pair,100000,103270.0,103260.0,-10.0
22,2117,players_4,SmartPlayer,lost,fold,big,one_pair,100000,103260.0,103250.0,-10.0
22,2118,players_4,SmartPlayer,lost,fold,None,one_pair,100000,103250.0,103240.0,-10.0
22,2119,players_4,SmartPlayer,lost,fold,None,one_pair,100000,103240.0,103230.0,-10.0
22,2120,players_4,SmartPlayer,lost,fold,small,one_pair,100000,103230.0,103220.0,-10.0
22,2121,players_4,SmartPlayer,lost,lost_game,big,two_pair,100000,103220.0,103010.0,-210.0
22,2122,players_4,SmartPlayer,lost,fold,None,two_pair,100000,103010.0,103000.0,-10.0
22,2123,players_4,SmartPlayer,lost,fold,None,two_pair,100000,103000.0,102990.0,-10.0
22,2124,players_4,SmartPlayer,lost,fold,small,two_pair,100000,102990.0,102780.0,-210.0
22,2125,players_4,SmartPlayer,lost,lost_game,big,two_pair,100000,102780.0,102670.0,-110.0
22,2126,players_4,SmartPlayer,lost,fold,None,two_pair,100000,102670.0,102660.0,-10.0
22,2127,players_4,SmartPlayer,lost,fold,None,two_pair,100000,102660.0,102650.0,-10.0
22,2128,players_4,SmartPlayer,lost,fold,small,two_pair,100000,102650.0,102640.0,-10.0
22,2129,players_4,SmartPlayer,lost,fold,big,two_pair,100000,102640.0,102630.0,-10.0
22,2130,players_4,SmartPlayer,lost,fold,None,two_pair,100000,102630.0,102620.0,-10.0
22,2131,players_4,SmartPlayer,lost,fold,None,two_pair,100000,102620.0,102610.0,-10.0
22,2132,players_4,SmartPlayer,lost,lost_game,small,one_pair,100000,102610.0,102600.0,-10.0
22,2133,players_4,SmartPlayer,lost,fold,big,one_pair,100000,102600.0,102590.0,-10.0
22,2134,players_4,SmartPlayer,won,won_game,None,two_pair,100000,102590.0,104120.0,1530.0
22,2135,players_4,SmartPlayer,lost,fold,None,two_pair,100000,104120.0,104110.0,-10.0
22,2136,players_4,SmartPlayer,lost,fold,small,two_pair,100000,104110.0,104100.0,-10.0
22,2137,players_4,SmartPlayer,lost,fold,big,two_pair,100000,104100.0,104090.0,-10.0
22,2138,players_4,SmartPlayer,lost,fold,None,two_pair,100000,104090.0,104080.0,-10.0
22,2139,players_4,SmartPlayer,won,won_game,None,straight,100000,104080.0,105310.0,1230.0
22,2140,players_4,SmartPlayer,lost,fold,small,straight,100000,105310.0,105300.0,-10.0
22,2141,players_4,SmartPlayer,lost,fold,big,straight,100000,105300.0,105290.0,-10.0
22,2142,players_4,SmartPlayer,lost,fold,None,straight,100000,105290.0,105280.0,-10.0
22,2143,players_4,SmartPlayer,lost,lost_game,None,two_pair,100000,105280.0,105070.0,-210.0
22,2144,players_4,SmartPlayer,won,won_game,small,two_pair,100000,105070.0,105700.0,630.0
22,2145,players_4,SmartPlayer,lost,lost_game,big,two_pair,100000,105700.0,105190.0,-510.0
22,2146,players_4,SmartPlayer,lost,fold,None,two_pair,100000,105190.0,105180.0,-10.0
22,2147,players_4,SmartPlayer,lost,lost_game,None,two_pair,100000,105180.0,104570.0,-610.0
22,2148,players_4,SmartPlayer,lost,fold,small,two_pair,100000,104570.0,104560.0,-10.0
22,2149,players_4,SmartPlayer,lost,fold,big,two_pair,100000,104560.0,104550.0,-10.0
22,2150,players_4,SmartPlayer,lost,fold,None,two_pair,100000,104550.0,104440.0,-110.0
22,2151,players_4,SmartPlayer,lost,fold,None,two_pair,100000,104440.0,104430.0,-10.0
22,2152,players_4,SmartPlayer,won,won_game,small,two_pair,100000,104430.0,105360.0,930.0
22,2153,players_4,SmartPlayer,lost,fold,big,two_pair,100000,105360.0,105350.0,-10.0
22,2154,players_4,SmartPlayer,lost,lost_game,None,one_pair,100000,105350.0,105340.0,-10.0
22,2155,players_4,SmartPlayer,lost,fold,None,one_pair,100000,105340.0,105330.0,-10.0
22,2156,players_4,SmartPlayer,lost,lost_game,small,two_pair,100000,105330.0,105320.0,-10.0
22,2157,players_4,SmartPlayer,lost,fold,big,two_pair,100000,105320.0,105310.0,-10.0
22,2158,players_4,SmartPlayer,lost,fold,None,two_pair,100000,105310.0,105300.0,-10.0
22,2159,players_4,SmartPlayer,lost,fold,None,two_pair,100000,105300.0,104990.0,-310.0
22,2160,players_4,SmartPlayer,lost,fold,small,two_pair,100000,104990.0,104980.0,-10.0
22,2161,players_4,SmartPlayer,won,won_game,big,full_house,100000,104980.0,106810.0,1830.0
22,2162,players_4,SmartPlayer,lost,fold,None,full_house,100000,106810.0,106800.0,-10.0
22,2163,players_4,SmartPlayer,won,won_game,None,two_pair,100000,106800.0,108030.0,1230.0
22,2164,players_4,SmartPlayer,lost,fold,small,two_pair,100000,108030.0,108020.0,-10.0
22,2165,players_4,SmartPlayer,lost,fold,big,two_pair,100000,108020.0,107810.0,-210.0
22,2166,players_4,SmartPlayer,won,won_game,None,straight,100000,107810.0,109040.0,1230.0
22,2167,players_4,SmartPlayer,lost,fold,None,straight,100000,109040.0,109030.0,-10.0
22,2168,players_4,SmartPlayer,lost,fold,small,straight,100000,109030.0,109020.0,-10.0
22,2169,players_4,SmartPlayer,lost,fold,big,straight,100000,109020.0,109010.0,-10.0
22,2170,players_4,SmartPlayer,lost,lost_game,None,three_of_kind,100000,109010.0,108300.0,-710.0
22,2171,players_4,SmartPlayer,lost,fold,None,three_of_kind,100000,108300.0,108290.0,-10.0
22,2172,players_4,SmartPlayer,lost,fold,small,three_of_kind,100000,108290.0,108280.0,-10.0
22,2173,players_4,SmartPlayer,lost,fold,big,three_of_kind,100000,108280.0,108270.0,-10.0
22,2174,players_4,SmartPlayer,lost,fold,None,three_of_kind,100000,108270.0,107860.0,-410.0
22,2175,players_4,SmartPlayer,lost,lost_game,None,two_pair,100000,107860.0,107350.0,-510.0
22,2176,players_4,SmartPlayer,won,won_game,small,two_pair,100000,107350.0,108880.0,1530.0
22,2177,players_4,SmartPlayer,lost,lost_game,big,two_pair,100000,108880.0,108670.0,-210.0
22,2178,players_4,SmartPlayer,lost,fold,None,two_pair,100000,108670.0,108460.0,-210.0
22,2179,players_4,SmartPlayer,lost,fold,None,two_pair,100000,108460.0,108450.0,-10.0
22,2180,players_4,SmartPlayer,lost,fold,small,two_pair,100000,108450.0,108440.0,-10.0
22,2181,players_4,SmartPlayer,won,won_game,big,three_of_kind,100000,108440.0,110270.0,1830.0
22,2182,players_4,SmartPlayer,lost,fold,None,three_of_kind,100000,110270.0,110260.0,-10.0
22,2183,players_4,SmartPlayer,lost,lost_game,None,one_pair,100000,110260.0,109950.0,-310.0
22,2184,players_4,SmartPlayer,lost,fold,small,one_pair,100000,109950.0,109940.0,-10.0
22,2185,players_4,SmartPlayer,lost,fold,big,one_pair,100000,109940.0,109730.0,-210.0
22,2186,players_4,SmartPlayer,lost,fold,None,one_pair,100000,109730.0,109720.0,-10.0
22,2187,players_4,SmartPlayer,lost,fold,None,one_pair,100000,109720.0,109710.0,-10.0
22,2188,players_4,SmartPlayer,lost,fold,small,one_pair,100000,109710.0,109700.0,-10.0
22,2189,players_4,SmartPlayer,lost,fold,big,one_pair,100000,109700.0,109690.0,-10.0
22,2190,players_4,SmartPlayer,lost,lost_game,None,one_pair,100000,109690.0,109180.0,-510.0
22,2191,players_4,SmartPlayer,lost,fold,None,one_pair,100000,109180.0,109170.0,-10.0
22,2192,players_4,SmartPlayer,won,won_game,small,one_pair,100000,109170.0,110100.0,930.0
22,2193,players_4,SmartPlayer,lost,fold,big,one_pair,100000,110100.0,110090.0,-10.0
22,2194,players_4,SmartPlayer,lost,fold,None,one_pair,100000,110090.0,110080.0,-10.0
22,2195,players_4,SmartPlayer,lost,fold,None,one_pair,100000,110080.0,109970.0,-110.0
22,2196,players_4,SmartPlayer,lost,fold,small,one_pair,100000,109970.0,109960.0,-10.0
22,2197,players_4,SmartPlayer,lost,lost_game,big,flush,100000,109960.0,109350.0,-610.0
22,2198,players_4,SmartPlayer,lost,fold,None,flush,100000,109350.0,109240.0,-110.0
22,2199,players_4,SmartPlayer,lost,fold,None,flush,100000,109240.0,109230.0,-10.0
22,2200,players_4,SmartPlayer,lost,lost_game,small,three_of_kind,100000,109230.0,108920.0,-310.0
