table_id,game_id,player_name,player_type,game_result,game_reason,blind_type,final_hand,beginning_balance,game_start_balance,game_end_balance,game_net_change
35,3401,players_1,AlwaysCallPlayer,won,won_game,None,full_house,100000,100000,100440.0,440.0
35,3402,players_1,AlwaysCallPlayer,lost,lost_game,None,two_pair,100000,100440.0,100430.0,-10.0
35,3403,players_1,AlwaysCallPlayer,lost,lost_game,None,high_card,100000,100430.0,100420.0,-10.0
35,3404,players_1,AlwaysCallPlayer,lost,lost_game,small,one_pair,100000,100420.0,100410.0,-10.0
35,3405,players_1,AlwaysCallPlayer,lost,lost_game,big,two_pair,100000,100410.0,99900.0,-510.0
35,3406,players_1,AlwaysCallPlayer,lost,lost_game,None,one_pair,100000,99900.0,99190.0,-710.0
35,3407,players_1,AlwaysCallPlayer,won,won_game,None,three_of_kind,100000,99190.0,99230.0,40.0
35,3408,players_1,AlwaysCallPlayer,lost,lost_game,None,two_pair,100000,99230.0,99220.0,-10.0
35,3409,players_1,AlwaysCallPlayer,lost,lost_game,small,two_pair,100000,99220.0,99210.0,-10.0
35,3410,players_1,AlwaysCallPlayer,lost,lost_game,big,one_pair,100000,99210.0,99200.0,-10.0
35,3411,players_1,AlwaysCallPlayer,lost,lost_game,None,one_pair,100000,99200.0,99190.0,-10.0
35,3412,players_1,AlwaysCallPlayer,lost,lost_game,None,two_pair,100000,99190.0,99180.0,-10.0
35,3413,players_1,AlwaysCallPlayer,lost,lost_game,None,high_card,100000,99180.0,98770.0,-410.0
35,3414,players_1,AlwaysCallPlayer,lost,lost_game,small,two_pair,100000,98770.0,98760.0,-10.0
35,3415,players_1,AlwaysCallPlayer,won,won_game,big,straight,100000,98760.0,100400.0,1640.0
35,3416,players_1,AlwaysCallPlayer,lost,lost_game,None,one_pair,100000,100400.0,100390.0,-10.0
35,3417,players_1,AlwaysCallPlayer,lost,lost_game,None,one_pair,100000,100390.0,100380.0,-10.0
35,3418,players_1,AlwaysCallPlayer,lost,lost_game,None,high_card,100000,100380.0,100370.0,-10.0
35,3419,players_1,AlwaysCallPlayer,lost,lost_game,small,two_pair,100000,100370.0,100360.0,-10.0
35,3420,players_1,AlwaysCallPlayer,won,won_game,big,straight,100000,100360.0,100395.0,35.0
35,3421,players_1,AlwaysCallPlayer,lost,lost_game,None,two_pair,100000,100395.0,100385.0,-10.0
35,3422,players_1,AlwaysCallPlayer,won,won_game,None,flush,100000,100385.0,100437.5,52.5
35,3423,players_1,AlwaysCallPlayer,lost,lost_game,None,one_pair,100000,100437.5,100427.5,-10.0
35,3424,players_1,AlwaysCallPlayer,lost,lost_game,small,high_card,100000,100427.5,99617.5,-810.0
35,3425,players_1,AlwaysCallPlayer,lost,lost_game,big,one_pair,100000,99617.5,99607.5,-10.0
35,3426,players_1,AlwaysCallPlayer,lost,lost_game,None,high_card,100000,99607.5,99597.5,-10.0
35,3427,players_1,AlwaysCallPlayer,lost,lost_game,None,two_pair,100000,99597.5,99587.5,-10.0
35,3428,players_1,AlwaysCallPlayer,lost,lost_game,None,one_pair,100000,99587.5,99577.5,-10.0
35,3429,players_1,AlwaysCallPlayer,lost,lost_game,small,one_pair,100000,99577.5,99167.5,-410.0
35,3430,players_1,AlwaysCallPlayer,won,won_game,big,flush,100000,99167.5,99207.5,40.0
35,3431,players_1,AlwaysCallPlayer,lost,lost_game,None,two_pair,100000,99207.5,99197.5,-10.0
35,3432,players_1,AlwaysCallPlayer,lost,lost_game,None,one_pair,100000,99197.5,99187.5,-10.0
35,3433,players_1,AlwaysCallPlayer,lost,lost_game,None,high_card,100000,99187.5,98977.5,-210.0
35,3434,players_1,AlwaysCallPlayer,won,won_game,small,two_pair,100000,98977.5,99017.5,40.0
35,3435,players_1,AlwaysCallPlayer,lost,lost_game,big,one_pair,100000,99017.5,99007.5,-10.0
35,3436,players_1,AlwaysCallPlayer,lost,lost_game,None,high_card,100000,99007.5,98997.5,-10.0
35,3437,players_1,AlwaysCallPlayer,lost,lost_game,None,one_pair,100000,98997.5,98387.5,-610.0
35,3438,players_1,AlwaysCallPlayer,won,won_game,None,two_pair,100000,98387.5,98427.5,40.0
35,3439,players_1,AlwaysCallPlayer,won,won_game,small,one_pair,100000,98427.5,99667.5,1240.0
35,3440,players_1,AlwaysCallPlayer,lost,lost_game,big,two_pair,100000,99667.5,99657.5,-10.0
35,3441,players_1,AlwaysCallPlayer,lost,lost_game,None,one_pair,100000,99657.5,99647.5,-10.0
35,3442,players_1,AlwaysCallPlayer,won,won_game,None,two_pair,100000,99647.5,100487.5,840.0
35,3443,players_1,AlwaysCallPlayer,lost,lost_game,None,high_card,100000,100487.5,99877.5,-610.0
35,3444,players_1,AlwaysCallPlayer,lost,lost_game,small,one_pair,100000,99877.5,99867.5,-10.0
35,3445,players_1,AlwaysCallPlayer,lost,lost_game,big,high_card,100000,99867.5,99657.5,-210.0
35,3446,players_1,AlwaysCallPlayer,lost,lost_game,None,one_pair,100000,99657.5,99047.5,-610.0
35,3447,players_1,AlwaysCallPlayer,lost,lost_game,None,one_pair,100000,99047.5,98937.5,-110.0
35,3448,players_1,AlwaysCallPlayer,lost,lost_game,None,one_pair,100000,98937.5,98927.5,-10.0
35,3449,players_1,AlwaysCallPlayer,lost,lost_game,small,two_pair,100000,98927.5,98117.5,-810.0
35,3450,players_1,AlwaysCallPlayer,lost,lost_game,big,one_pair,100000,98117.5,98107.5,-10.0
35,3451,players_1,AlwaysCallPlayer,lost,lost_game,None,two_pair,100000,98107.5,98097.5,-10.0
35,3452,players_1,AlwaysCallPlayer,won,won_game,None,full_house,100000,98097.5,98137.5,40.0
35,3453,players_1,AlwaysCallPlayer,lost,lost_game,None,high_card,100000,98137.5,98127.5,-10.0
35,3454,players_1,AlwaysCallPlayer,won,won_game,small,flush,100000,98127.5,98167.5,40.0
35,3455,players_1,AlwaysCallPlayer,lost,lost_game,big,one_pair,100000,98167.5,98157.5,-10.0
35,3456,players_1,AlwaysCallPlayer,lost,lost_game,None,one_pair,100000,98157.5,98147.5,-10.0
35,3457,players_1,AlwaysCallPlayer,won,won_game,None,two_pair,100000,98147.5,98187.5,40.0
35,3458,players_1,AlwaysCallPlayer,lost,lost_game,None,two_pair,100000,98187.5,98077.5,-110.0
35,3459,players_1,AlwaysCallPlayer,lost,lost_game,small,one_pair,100000,98077.5,97967.5,-110.0
35,3460,players_1,AlwaysCallPlayer,lost,lost_game,big,two_pair,100000,97967.5,97957.5,-10.0
35,3461,players_1,AlwaysCallPlayer,lost,lost_game,None,one_pair,100000,97957.5,97747.5,-210.0
35,3462,players_1,AlwaysCallPlayer,lost,lost_game,None,three_of_kind,100000,97747.5,97137.5,-610.0
35,3463,players_1,AlwaysCallPlayer,lost,lost_game,None,one_pair,100000,97137.5,96327.5,-810.0
35,3464,players_1,AlwaysCallPlayer,won,won_game,small,flush,100000,96327.5,96334.16666666667,6.666666666671517
35,3465,players_1,AlwaysCallPlayer,lost,lost_game,big,one_pair,100000,96334.16666666667,96324.16666666667,-10.0
35,3466,players_1,AlwaysCallPlayer,lost,lost_game,None,two_pair,100000,96324.16666666667,96314.16666666667,-10.0
35,3467,players_1,AlwaysCallPlayer,won,won_game,None,straight,100000,96314.16666666667,96929.16666666667,615.0
35,3468,players_1,AlwaysCallPlayer,lost,lost_game,None,one_pair,100000,96929.16666666667,96919.16666666667,-10.0
35,3469,players_1,AlwaysCallPlayer,won,won_game,small,three_of_kind,100000,96919.16666666667,99759.16666666667,2840.0
35,3470,players_1,AlwaysCallPlayer,won,won_game,big,one_pair,100000,99759.16666666667,100999.16666666667,1240.0
35,3471,players_1,AlwaysCallPlayer,won,won_game,None,two_pair,100000,100999.16666666667,101039.16666666667,40.0
35,3472,players_1,AlwaysCallPlayer,lost,lost_game,None,one_pair,100000,101039.16666666667,100929.16666666667,-110.0
35,3473,players_1,AlwaysCallPlayer,lost,lost_game,None,two_pair,100000,100929.16666666667,100919.16666666667,-10.0
35,3474,players_1,AlwaysCallPlayer,won,won_game,small,three_of_kind,100000,100919.16666666667,100959.16666666667,40.0
35,3475,players_1,AlwaysCallPlayer,won,won_game,big,straight,100000,100959.16666666667,101799.16666666667,840.0
35,3476,players_1,AlwaysCallPlayer,lost,lost_game,None,two_pair,100000,101799.16666666667,101789.16666666667,-10.0
35,3477,players_1,AlwaysCallPlayer,lost,lost_game,None,one_pair,100000,101789.16666666667,101779.16666666667,-10.0
35,3478,players_1,AlwaysCallPlayer,lost,lost_game,None,two_pair,100000,101779.16666666667,101769.16666666667,-10.0
35,3479,players_1,AlwaysCallPlayer,lost,lost_game,small,two_pair,100000,101769.16666666667,101259.16666666667,-510.0
35,3480,players_1,AlwaysCallPlayer,lost,lost_game,big,one_pair,100000,101259.16666666667,101149.16666666667,-110.0
35,3481,players_1,AlwaysCallPlayer,lost,lost_game,None,one_pair,100000,101149.16666666667,101039.16666666667,-110.0
35,3482,players_1,AlwaysCallPlayer,lost,lost_game,None,one_pair,100000,101039.16666666667,101029.16666666667,-10.0
35,3483,players_1,AlwaysCallPlayer,lost,lost_game,None,one_pair,100000,101029.16666666667,100619.16666666667,-410.0
35,3484,players_1,AlwaysCallPlayer,lost,lost_game,small,flush,100000,100619.16666666667,100609.16666666667,-10.0
35,3485,players_1,AlwaysCallPlayer,lost,lost_game,big,high_card,100000,100609.16666666667,100399.16666666667,-210.0
35,3486,players_1,AlwaysCallPlayer,lost,lost_game,None,high_card,100000,100399.16666666667,100389.16666666667,-10.0
35,3487,players_1,AlwaysCallPlayer,lost,lost_game,None,one_pair,100000,100389.16666666667,100379.16666666667,-10.0
35,3488,players_1,AlwaysCallPlayer,lost,lost_game,None,straight,100000,100379.16666666667,100369.16666666667,-10.0
35,3489,players_1,AlwaysCallPlayer,won,won_game,small,one_pair,100000,100369.16666666667,100409.16666666667,40.0
35,3490,players_1,AlwaysCallPlayer,won,won_game,big,one_pair,100000,100409.16666666667,101249.16666666667,840.0
35,3491,players_1,AlwaysCallPlayer,lost,lost_game,None,high_card,100000,101249.16666666667,101239.16666666667,-10.0
35,3492,players_1,AlwaysCallPlayer,lost,lost_game,None,one_pair,100000,101239.16666666667,101129.16666666667,-110.0
35,3493,players_1,AlwaysCallPlayer,lost,lost_game,None,two_pair,100000,101129.16666666667,100919.16666666667,-210.0
35,3494,players_1,AlwaysCallPlayer,lost,lost_game,small,flush,100000,100919.16666666667,100709.16666666667,-210.0
35,3495,players_1,AlwaysCallPlayer,lost,lost_game,big,one_pair,100000,100709.16666666667,100699.16666666667,-10.0
35,3496,players_1,AlwaysCallPlayer,lost,lost_game,None,high_card,100000,100699.16666666667,100689.16666666667,-10.0
35,3497,players_1,AlwaysCallPlayer,won,won_game,None,flush,100000,100689.16666666667,103529.16666666667,2840.0
35,3498,players_1,AlwaysCallPlayer,lost,lost_game,None,one_pair,100000,103529.16666666667,103519.16666666667,-10.0
35,3499,players_1,AlwaysCallPlayer,won,won_game,small,two_pair,100000,103519.16666666667,103834.16666666667,315.0
35,3500,players_1,AlwaysCallPlayer,won,won_game,big,two_pair,100000,103834.16666666667,103874.16666666667,40.0
35,3401,players_2,AlwaysCallPlayer,lost,lost_game,None,one_pair,100000,100000,99890,-110
35,3402,players_2,AlwaysCallPlayer,won,won_game,None,two_pair,100000,99890,99930.0,40.0
35,3403,players_2,AlwaysCallPlayer,lost,lost_game,small,high_card,100000,99930.0,99920.0,-10.0
35,3404,players_2,AlwaysCallPlayer,won,won_game,big,two_pair,100000,99920.0,99960.0,40.0
35,3405,players_2,AlwaysCallPlayer,lost,lost_game,None,one_pair,100000,99960.0,99450.0,-510.0
35,3406,players_2,AlwaysCallPlayer,won,won_game,None,one_pair,100000,99450.0,102290.0,2840.0
35,3407,players_2,AlwaysCallPlayer,lost,lost_game,None,one_pair,100000,102290.0,102280.0,-10.0
35,3408,players_2,AlwaysCallPlayer,won,won_game,small,two_pair,100000,102280.0,102320.0,40.0
35,3409,players_2,AlwaysCallPlayer,lost,lost_game,big,two_pair,100000,102320.0,102310.0,-10.0
35,3410,players_2,AlwaysCallPlayer,lost,lost_game,None,one_pair,100000,102310.0,102300.0,-10.0
35,3411,players_2,AlwaysCallPlayer,lost,lost_game,None,one_pair,100000,102300.0,102290.0,-10.0
35,3412,players_2,AlwaysCallPlayer,lost,lost_game,None,one_pair,100000,102290.0,102280.0,-10.0
35,3413,players_2,AlwaysCallPlayer,lost,lost_game,small,high_card,100000,102280.0,101870.0,-410.0
35,3414,players_2,AlwaysCallPlayer,won,won_game,big,full_house,100000,101870.0,101910.0,40.0
35,3415,players_2,AlwaysCallPlayer,lost,lost_game,None,straight,100000,101910.0,101500.0,-410.0
35,3416,players_2,AlwaysCallPlayer,won,won_game,None,two_pair,100000,101500.0,101540.0,40.0
35,3417,players_2,AlwaysCallPlayer,won,won_game,None,two_pair,100000,101540.0,101580.0,40.0
35,3418,players_2,AlwaysCallPlayer,lost,lost_game,small,high_card,100000,101580.0,101570.0,-10.0
35,3419,players_2,AlwaysCallPlayer,won,won_game,big,two_pair,100000,101570.0,101610.0,40.0
35,3420,players_2,AlwaysCallPlayer,lost,lost_game,None,one_pair,100000,101610.0,101600.0,-10.0
35,3421,players_2,AlwaysCallPlayer,lost,lost_game,None,one_pair,100000,101600.0,101590.0,-10.0
35,3422,players_2,AlwaysCallPlayer,lost,lost_game,None,three_of_kind,100000,101590.0,101380.0,-210.0
35,3423,players_2,AlwaysCallPlayer,lost,lost_game,small,two_pair,100000,101380.0,101370.0,-10.0
35,3424,players_2,AlwaysCallPlayer,won,won_game,big,straight,100000,101370.0,104610.0,3240.0
35,3425,players_2,AlwaysCallPlayer,lost,lost_game,None,high_card,100000,104610.0,104600.0,-10.0
35,3426,players_2,AlwaysCallPlayer,lost,lost_game,None,one_pair,100000,104600.0,104590.0,-10.0
35,3427,players_2,AlwaysCallPlayer,lost,lost_game,None,two_pair,100000,104590.0,104580.0,-10.0
35,3428,players_2,AlwaysCallPlayer,lost,lost_game,small,one_pair,100000,104580.0,104570.0,-10.0
35,3429,players_2,AlwaysCallPlayer,won,won_game,big,straight_flush,100000,104570.0,106210.0,1640.0
35,3430,players_2,AlwaysCallPlayer,lost,lost_game,None,two_pair,100000,106210.0,106200.0,-10.0
35,3431,players_2,AlwaysCallPlayer,won,won_game,None,full_house,100000,106200.0,106240.0,40.0
35,3432,players_2,AlwaysCallPlayer,won,won_game,None,three_of_kind,100000,106240.0,106280.0,40.0
35,3433,players_2,AlwaysCallPlayer,lost,lost_game,small,one_pair,100000,106280.0,106070.0,-210.0
35,3434,players_2,AlwaysCallPlayer,lost,lost_game,big,one_pair,100000,106070.0,106060.0,-10.0
35,3435,players_2,AlwaysCallPlayer,lost,lost_game,None,high_card,100000,106060.0,106050.0,-10.0
35,3436,players_2,AlwaysCallPlayer,won,won_game,None,straight,100000,106050.0,106090.0,40.0
35,3437,players_2,AlwaysCallPlayer,lost,lost_game,None,one_pair,100000,106090.0,105480.0,-610.0
35,3438,players_2,AlwaysCallPlayer,lost,lost_game,small,high_card,100000,105480.0,105470.0,-10.0
35,3439,players_2,AlwaysCallPlayer,lost,lost_game,big,one_pair,100000,105470.0,105160.0,-310.0
35,3440,players_2,AlwaysCallPlayer,lost,lost_game,None,three_of_kind,100000,105160.0,105150.0,-10.0
35,3441,players_2,AlwaysCallPlayer,lost,lost_game,None,high_card,100000,105150.0,105140.0,-10.0
35,3442,players_2,AlwaysCallPlayer,lost,lost_game,None,one_pair,100000,105140.0,104930.0,-210.0
35,3443,players_2,AlwaysCallPlayer,lost,lost_game,small,high_card,100000,104930.0,104320.0,-610.0
35,3444,players_2,AlwaysCallPlayer,lost,lost_game,big,high_card,100000,104320.0,104310.0,-10.0
35,3445,players_2,AlwaysCallPlayer,lost,lost_game,None,high_card,100000,104310.0,104100.0,-210.0
35,3446,players_2,AlwaysCallPlayer,lost,lost_game,None,high_card,100000,104100.0,103490.0,-610.0
35,3447,players_2,AlwaysCallPlayer,won,won_game,None,straight,100000,103490.0,103930.0,440.0
35,3448,players_2,AlwaysCallPlayer,lost,lost_game,small,one_pair,100000,103930.0,103920.0,-10.0
35,3449,players_2,AlwaysCallPlayer,lost,lost_game,big,two_pair,100000,103920.0,103110.0,-810.0
35,3450,players_2,AlwaysCallPlayer,won,won_game,None,one_pair,100000,103110.0,103150.0,40.0
35,3451,players_2,AlwaysCallPlayer,lost,lost_game,None,one_pair,100000,103150.0,103140.0,-10.0
35,3452,players_2,AlwaysCallPlayer,lost,lost_game,None,two_pair,100000,103140.0,103130.0,-10.0
35,3453,players_2,AlwaysCallPlayer,won,won_game,small,one_pair,100000,103130.0,103170.0,40.0
35,3454,players_2,AlwaysCallPlayer,lost,lost_game,big,two_pair,100000,103170.0,103160.0,-10.0
35,3455,players_2,AlwaysCallPlayer,won,won_game,None,flush,100000,103160.0,103200.0,40.0
35,3456,players_2,AlwaysCallPlayer,won,won_game,None,two_pair,100000,103200.0,103240.0,40.0
35,3457,players_2,AlwaysCallPlayer,lost,lost_game,None,one_pair,100000,103240.0,103230.0,-10.0
35,3458,players_2,AlwaysCallPlayer,won,won_game,small,flush,100000,103230.0,103670.0,440.0
35,3459,players_2,AlwaysCallPlayer,won,won_game,big,two_pair,100000,103670.0,104110.0,440.0
35,3460,players_2,AlwaysCallPlayer,lost,lost_game,None,two_pair,100000,104110.0,104100.0,-10.0
35,3461,players_2,AlwaysCallPlayer,lost,lost_game,None,one_pair,100000,104100.0,103890.0,-210.0
35,3462,players_2,AlwaysCallPlayer,lost,lost_game,None,full_house,100000,103890.0,103280.0,-610.0
35,3463,players_2,AlwaysCallPlayer,lost,lost_game,small,three_of_kind,100000,103280.0,102470.0,-810.0
35,3464,players_2,AlwaysCallPlayer,won,won_game,big,flush,100000,102470.0,102476.66666666667,6.666666666671517
35,3465,players_2,AlwaysCallPlayer,lost,lost_game,None,two_pair,100000,102476.66666666667,102466.66666666667,-10.0
35,3466,players_2,AlwaysCallPlayer,lost,lost_game,None,one_pair,100000,102466.66666666667,102456.66666666667,-10.0
35,3467,players_2,AlwaysCallPlayer,lost,lost_game,None,one_pair,100000,102456.66666666667,102046.66666666667,-410.0
35,3468,players_2,AlwaysCallPlayer,lost,lost_game,small,high_card,100000,102046.66666666667,102036.66666666667,-10.0
35,3469,players_2,AlwaysCallPlayer,lost,lost_game,big,one_pair,100000,102036.66666666667,101326.66666666667,-710.0
35,3470,players_2,AlwaysCallPlayer,lost,lost_game,None,one_pair,100000,101326.66666666667,101016.66666666667,-310.0
35,3471,players_2,AlwaysCallPlayer,lost,lost_game,None,one_pair,100000,101016.66666666667,101006.66666666667,-10.0
35,3472,players_2,AlwaysCallPlayer,lost,lost_game,None,one_pair,100000,101006.66666666667,100896.66666666667,-110.0
35,3473,players_2,AlwaysCallPlayer,lost,lost_game,small,one_pair,100000,100896.66666666667,100886.66666666667,-10.0
35,3474,players_2,AlwaysCallPlayer,lost,lost_game,big,one_pair,100000,100886.66666666667,100876.66666666667,-10.0
35,3475,players_2,AlwaysCallPlayer,lost,lost_game,None,two_pair,100000,100876.66666666667,100666.66666666667,-210.0
35,3476,players_2,AlwaysCallPlayer,lost,lost_game,None,one_pair,100000,100666.66666666667,100656.66666666667,-10.0
35,3477,players_2,AlwaysCallPlayer,lost,lost_game,None,one_pair,100000,100656.66666666667,100646.66666666667,-10.0
35,3478,players_2,AlwaysCallPlayer,lost,lost_game,small,two_pair,100000,100646.66666666667,100636.66666666667,-10.0
35,3479,players_2,AlwaysCallPlayer,won,won_game,big,flush,100000,100636.66666666667,102676.66666666667,2040.0
35,3480,players_2,AlwaysCallPlayer,won,won_game,None,full_house,100000,102676.66666666667,103116.66666666667,440.0
35,3481,players_2,AlwaysCallPlayer,won,won_game,None,two_pair,100000,103116.66666666667,103556.66666666667,440.0
35,3482,players_2,AlwaysCallPlayer,lost,lost_game,None,one_pair,100000,103556.66666666667,103546.66666666667,-10.0
35,3483,players_2,AlwaysCallPlayer,won,won_game,small,one_pair,100000,103546.66666666667,104161.66666666667,615.0
35,3484,players_2,AlwaysCallPlayer,lost,lost_game,big,high_card,100000,104161.66666666667,104151.66666666667,-10.0
35,3485,players_2,AlwaysCallPlayer,lost,lost_game,None,high_card,100000,104151.66666666667,103941.66666666667,-210.0
35,3486,players_2,AlwaysCallPlayer,won,won_game,None,two_pair,100000,103941.66666666667,103981.66666666667,40.0
35,3487,players_2,AlwaysCallPlayer,lost,lost_game,None,one_pair,100000,103981.66666666667,103971.66666666667,-10.0
35,3488,players_2,AlwaysCallPlayer,lost,lost_game,small,one_pair,100000,103971.66666666667,103961.66666666667,-10.0
35,3489,players_2,AlwaysCallPlayer,lost,lost_game,big,high_card,100000,103961.66666666667,103951.66666666667,-10.0
35,3490,players_2,AlwaysCallPlayer,lost,lost_game,None,high_card,100000,103951.66666666667,103741.66666666667,-210.0
35,3491,players_2,AlwaysCallPlayer,won,won_game,None,two_pair,100000,103741.66666666667,103781.66666666667,40.0
35,3492,players_2,AlwaysCallPlayer,lost,lost_game,None,one_pair,100000,103781.66666666667,103671.66666666667,-110.0
35,3493,players_2,AlwaysCallPlayer,lost,lost_game,small,one_pair,100000,103671.66666666667,103461.66666666667,-210.0
35,3494,players_2,AlwaysCallPlayer,lost,lost_game,big,two_pair,100000,103461.66666666667,103251.66666666667,-210.0
35,3495,players_2,AlwaysCallPlayer,lost,lost_game,None,two_pair,100000,103251.66666666667,103241.66666666667,-10.0
35,3496,players_2,AlwaysCallPlayer,lost,lost_game,None,one_pair,100000,103241.66666666667,103231.66666666667,-10.0
35,3497,players_2,AlwaysCallPlayer,lost,lost_game,None,straight,100000,103231.66666666667,102521.66666666667,-710.0
35,3498,players_2,AlwaysCallPlayer,lost,lost_game,small,one_pair,100000,102521.66666666667,102511.66666666667,-10.0
35,3499,players_2,AlwaysCallPlayer,won,won_game,big,two_pair,100000,102511.66666666667,102826.66666666667,315.0
35,3500,players_2,AlwaysCallPlayer,lost,lost_game,None,one_pair,100000,102826.66666666667,102816.66666666667,-10.0
35,3401,players_3,AlwaysCallPlayer,lost,lost_game,None,one_pair,100000,100000,99890,-110
35,3402,players_3,AlwaysCallPlayer,lost,lost_game,small,one_pair,100000,99890,99880,-10
35,3403,players_3,AlwaysCallPlayer,lost,lost_game,big,high_card,100000,99880,99870,-10
35,3404,players_3,AlwaysCallPlayer,lost,lost_game,None,one_pair,100000,99870,99860,-10
35,3405,players_3,AlwaysCallPlayer,lost,lost_game,None,two_pair,100000,99860,99350,-510
35,3406,players_3,AlwaysCallPlayer,lost,lost_game,None,high_card,100000,99350,98640,-710
35,3407,players_3,AlwaysCallPlayer,lost,lost_game,small,high_card,100000,98640,98630,-10
35,3408,players_3,AlwaysCallPlayer,lost,lost_game,big,one_pair,100000,98630,98620,-10
35,3409,players_3,AlwaysCallPlayer,won,won_game,None,straight,100000,98620,98660.0,40.0
35,3410,players_3,AlwaysCallPlayer,lost,lost_game,None,one_pair,100000,98660.0,98650.0,-10.0
35,3411,players_3,AlwaysCallPlayer,lost,lost_game,None,one_pair,100000,98650.0,98640.0,-10.0
35,3412,players_3,AlwaysCallPlayer,lost,lost_game,small,two_pair,100000,98640.0,98630.0,-10.0
35,3413,players_3,AlwaysCallPlayer,lost,lost_game,big,one_pair,100000,98630.0,98220.0,-410.0
35,3414,players_3,AlwaysCallPlayer,lost,lost_game,None,two_pair,100000,98220.0,98210.0,-10.0
35,3415,players_3,AlwaysCallPlayer,lost,lost_game,None,one_pair,100000,98210.0,97800.0,-410.0
35,3416,players_3,AlwaysCallPlayer,lost,lost_game,None,one_pair,100000,97800.0,97790.0,-10.0
35,3417,players_3,AlwaysCallPlayer,lost,lost_game,small,one_pair,100000,97790.0,97780.0,-10.0
35,3418,players_3,AlwaysCallPlayer,lost,lost_game,big,two_pair,100000,97780.0,97770.0,-10.0
35,3419,players_3,AlwaysCallPlayer,lost,lost_game,None,two_pair,100000,97770.0,97760.0,-10.0
35,3420,players_3,AlwaysCallPlayer,lost,lost_game,None,high_card,100000,97760.0,97750.0,-10.0
35,3421,players_3,AlwaysCallPlayer,won,won_game,None,two_pair,100000,97750.0,97790.0,40.0
35,3422,players_3,AlwaysCallPlayer,won,won_game,small,flush,100000,97790.0,97842.5,52.5
35,3423,players_3,AlwaysCallPlayer,lost,lost_game,big,one_pair,100000,97842.5,97832.5,-10.0
35,3424,players_3,AlwaysCallPlayer,lost,lost_game,None,one_pair,100000,97832.5,97022.5,-810.0
35,3425,players_3,AlwaysCallPlayer,lost,lost_game,None,high_card,100000,97022.5,97012.5,-10.0
35,3426,players_3,AlwaysCallPlayer,won,won_game,None,one_pair,100000,97012.5,97052.5,40.0
35,3427,players_3,AlwaysCallPlayer,won,won_game,small,two_pair,100000,97052.5,97092.5,40.0
35,3428,players_3,AlwaysCallPlayer,won,won_game,big,straight,100000,97092.5,97132.5,40.0
35,3429,players_3,AlwaysCallPlayer,lost,lost_game,None,flush,100000,97132.5,96722.5,-410.0
35,3430,players_3,AlwaysCallPlayer,lost,lost_game,None,one_pair,100000,96722.5,96712.5,-10.0
35,3431,players_3,AlwaysCallPlayer,lost,lost_game,None,two_pair,100000,96712.5,96702.5,-10.0
35,3432,players_3,AlwaysCallPlayer,lost,lost_game,small,one_pair,100000,96702.5,96692.5,-10.0
35,3433,players_3,AlwaysCallPlayer,lost,lost_game,big,one_pair,100000,96692.5,96482.5,-210.0
35,3434,players_3,AlwaysCallPlayer,lost,lost_game,None,two_pair,100000,96482.5,96472.5,-10.0
35,3435,players_3,AlwaysCallPlayer,won,won_game,None,one_pair,100000,96472.5,96512.5,40.0
35,3436,players_3,AlwaysCallPlayer,lost,lost_game,None,high_card,100000,96512.5,96502.5,-10.0
35,3437,players_3,AlwaysCallPlayer,lost,lost_game,small,high_card,100000,96502.5,95892.5,-610.0
35,3438,players_3,AlwaysCallPlayer,lost,lost_game,big,one_pair,100000,95892.5,95882.5,-10.0
35,3439,players_3,AlwaysCallPlayer,lost,lost_game,None,high_card,100000,95882.5,95572.5,-310.0
35,3440,players_3,AlwaysCallPlayer,lost,lost_game,None,one_pair,100000,95572.5,95562.5,-10.0
35,3441,players_3,AlwaysCallPlayer,lost,lost_game,None,high_card,100000,95562.5,95552.5,-10.0
35,3442,players_3,AlwaysCallPlayer,lost,lost_game,small,one_pair,100000,95552.5,95342.5,-210.0
35,3443,players_3,AlwaysCallPlayer,lost,lost_game,big,one_pair,100000,95342.5,94732.5,-610.0
35,3444,players_3,AlwaysCallPlayer,won,won_game,None,one_pair,100000,94732.5,94772.5,40.0
35,3445,players_3,AlwaysCallPlayer,won,won_game,None,one_pair,100000,94772.5,95612.5,840.0
35,3446,players_3,AlwaysCallPlayer,lost,lost_game,None,one_pair,100000,95612.5,95002.5,-610.0
35,3447,players_3,AlwaysCallPlayer,lost,lost_game,small,one_pair,100000,95002.5,94892.5,-110.0
35,3448,players_3,AlwaysCallPlayer,lost,lost_game,big,one_pair,100000,94892.5,94882.5,-10.0
35,3449,players_3,AlwaysCallPlayer,lost,lost_game,None,two_pair,100000,94882.5,94072.5,-810.0
35,3450,players_3,AlwaysCallPlayer,lost,lost_game,None,one_pair,100000,94072.5,94062.5,-10.0
35,3451,players_3,AlwaysCallPlayer,won,won_game,None,flush,100000,94062.5,94077.5,15.0
35,3452,players_3,AlwaysCallPlayer,lost,lost_game,small,one_pair,100000,94077.5,94067.5,-10.0
35,3453,players_3,AlwaysCallPlayer,lost,lost_game,big,high_card,100000,94067.5,94057.5,-10.0
35,3454,players_3,AlwaysCallPlayer,lost,lost_game,None,two_pair,100000,94057.5,94047.5,-10.0
35,3455,players_3,AlwaysCallPlayer,lost,lost_game,None,straight,100000,94047.5,94037.5,-10.0
35,3456,players_3,AlwaysCallPlayer,lost,lost_game,None,one_pair,100000,94037.5,94027.5,-10.0
35,3457,players_3,AlwaysCallPlayer,lost,lost_game,small,one_pair,100000,94027.5,94017.5,-10.0
35,3458,players_3,AlwaysCallPlayer,lost,lost_game,big,two_pair,100000,94017.5,93907.5,-110.0
35,3459,players_3,AlwaysCallPlayer,lost,lost_game,None,two_pair,100000,93907.5,93797.5,-110.0
35,3460,players_3,AlwaysCallPlayer,lost,lost_game,None,one_pair,100000,93797.5,93787.5,-10.0
35,3461,players_3,AlwaysCallPlayer,won,won_game,None,three_of_kind,100000,93787.5,94627.5,840.0
35,3462,players_3,AlwaysCallPlayer,lost,lost_game,small,three_of_kind,100000,94627.5,94017.5,-610.0
35,3463,players_3,AlwaysCallPlayer,lost,lost_game,big,straight,100000,94017.5,93207.5,-810.0
35,3464,players_3,AlwaysCallPlayer,lost,lost_game,None,one_pair,100000,93207.5,93197.5,-10.0
35,3465,players_3,AlwaysCallPlayer,won,won_game,None,full_house,100000,93197.5,93237.5,40.0
35,3466,players_3,AlwaysCallPlayer,won,won_game,None,three_of_kind,100000,93237.5,93277.5,40.0
35,3467,players_3,AlwaysCallPlayer,lost,lost_game,small,high_card,100000,93277.5,92867.5,-410.0
35,3468,players_3,AlwaysCallPlayer,won,won_game,big,two_pair,100000,92867.5,92907.5,40.0
35,3469,players_3,AlwaysCallPlayer,lost,lost_game,None,two_pair,100000,92907.5,92197.5,-710.0
35,3470,players_3,AlwaysCallPlayer,lost,lost_game,None,high_card,100000,92197.5,91887.5,-310.0
35,3471,players_3,AlwaysCallPlayer,lost,lost_game,None,high_card,100000,91887.5,91877.5,-10.0
35,3472,players_3,AlwaysCallPlayer,won,won_game,small,flush,100000,91877.5,92317.5,440.0
35,3473,players_3,AlwaysCallPlayer,lost,lost_game,big,two_pair,100000,92317.5,92307.5,-10.0
35,3474,players_3,AlwaysCallPlayer,lost,lost_game,None,one_pair,100000,92307.5,92297.5,-10.0
35,3475,players_3,AlwaysCallPlayer,lost,lost_game,None,one_pair,100000,92297.5,92087.5,-210.0
35,3476,players_3,AlwaysCallPlayer,won,won_game,None,straight,100000,92087.5,92127.5,40.0
35,3477,players_3,AlwaysCallPlayer,lost,lost_game,small,one_pair,100000,92127.5,92117.5,-10.0
35,3478,players_3,AlwaysCallPlayer,won,won_game,big,flush,100000,92117.5,92157.5,40.0
35,3479,players_3,AlwaysCallPlayer,lost,lost_game,None,one_pair,100000,92157.5,91647.5,-510.0
35,3480,players_3,AlwaysCallPlayer,lost,lost_game,None,two_pair,100000,91647.5,91537.5,-110.0
35,3481,players_3,AlwaysCallPlayer,lost,lost_game,None,one_pair,100000,91537.5,91427.5,-110.0
35,3482,players_3,AlwaysCallPlayer,lost,lost_game,small,high_card,100000,91427.5,91417.5,-10.0
35,3483,players_3,AlwaysCallPlayer,lost,lost_game,big,high_card,100000,91417.5,91007.5,-410.0
35,3484,players_3,AlwaysCallPlayer,lost,lost_game,None,straight,100000,91007.5,90997.5,-10.0
35,3485,players_3,AlwaysCallPlayer,won,won_game,None,two_pair,100000,90997.5,91837.5,840.0
35,3486,players_3,AlwaysCallPlayer,lost,lost_game,None,high_card,100000,91837.5,91827.5,-10.0
35,3487,players_3,AlwaysCallPlayer,won,won_game,small,three_of_kind,100000,91827.5,91867.5,40.0
35,3488,players_3,AlwaysCallPlayer,lost,lost_game,big,one_pair,100000,91867.5,91857.5,-10.0
35,3489,players_3,AlwaysCallPlayer,lost,lost_game,None,one_pair,100000,91857.5,91847.5,-10.0
35,3490,players_3,AlwaysCallPlayer,lost,lost_game,None,high_card,100000,91847.5,91637.5,-210.0
35,3491,players_3,AlwaysCallPlayer,lost,lost_game,None,one_pair,100000,91637.5,91627.5,-10.0
35,3492,players_3,AlwaysCallPlayer,won,won_game,small,one_pair,100000,91627.5,92067.5,440.0
35,3493,players_3,AlwaysCallPlayer,won,won_game,big,full_house,100000,92067.5,92907.5,840.0
35,3494,players_3,AlwaysCallPlayer,won,won_game,None,flush,100000,92907.5,93747.5,840.0
35,3495,players_3,AlwaysCallPlayer,won,won_game,None,two_pair,100000,93747.5,93787.5,40.0
35,3496,players_3,AlwaysCallPlayer,lost,lost_game,None,one_pair,100000,93787.5,93777.5,-10.0
35,3497,players_3,AlwaysCallPlayer,lost,lost_game,small,one_pair,100000,93777.5,93067.5,-710.0
35,3498,players_3,AlwaysCallPlayer,lost,lost_game,big,high_card,100000,93067.5,93057.5,-10.0
35,3499,players_3,AlwaysCallPlayer,lost,lost_game,None,one_pair,100000,93057.5,92847.5,-210.0
35,3500,players_3,AlwaysCallPlayer,lost,lost_game,None,two_pair,100000,92847.5,92837.5,-10.0
35,3401,players_4,AlwaysCallPlayer,lost,lost_game,small,two_pair,100000,100000,99890,-110
35,3402,players_4,AlwaysCallPlayer,lost,lost_game,big,two_pair,100000,99890,99880,-10
35,3403,players_4,AlwaysCallPlayer,won,won_game,None,one_pair,100000,99880,99920.0,40.0
35,3404,players_4,AlwaysCallPlayer,lost,lost_game,None,one_pair,100000,99920.0,99910.0,-10.0
35,3405,players_4,AlwaysCallPlayer,lost,lost_game,None,one_pair,100000,99910.0,99400.0,-510.0
35,3406,players_4,AlwaysCallPlayer,lost,lost_game,small,high_card,100000,99400.0,98690.0,-710.0
35,3407,players_4,AlwaysCallPlayer,lost,lost_game,big,high_card,100000,98690.0,98680.0,-10.0
35,3408,players_4,AlwaysCallPlayer,lost,lost_game,None,one_pair,100000,98680.0,98670.0,-10.0
35,3409,players_4,AlwaysCallPlayer,lost,lost_game,None,one_pair,100000,98670.0,98660.0,-10.0
35,3410,players_4,AlwaysCallPlayer,won,won_game,None,straight,100000,98660.0,98700.0,40.0
35,3411,players_4,AlwaysCallPlayer,won,won_game,small,two_pair,100000,98700.0,98740.0,40.0
35,3412,players_4,AlwaysCallPlayer,won,won_game,big,flush,100000,98740.0,98780.0,40.0
35,3413,players_4,AlwaysCallPlayer,won,won_game,None,one_pair,100000,98780.0,100420.0,1640.0
35,3414,players_4,AlwaysCallPlayer,lost,lost_game,None,two_pair,100000,100420.0,100410.0,-10.0
35,3415,players_4,AlwaysCallPlayer,lost,lost_game,None,one_pair,100000,100410.0,100000.0,-410.0
35,3416,players_4,AlwaysCallPlayer,lost,lost_game,small,one_pair,100000,100000.0,99990.0,-10.0
35,3417,players_4,AlwaysCallPlayer,lost,lost_game,big,high_card,100000,99990.0,99980.0,-10.0
35,3418,players_4,AlwaysCallPlayer,won,won_game,None,flush,100000,99980.0,100020.0,40.0
35,3419,players_4,AlwaysCallPlayer,lost,lost_game,None,one_pair,100000,100020.0,100010.0,-10.0
35,3420,players_4,AlwaysCallPlayer,lost,lost_game,None,two_pair,100000,100010.0,100000.0,-10.0
35,3421,players_4,AlwaysCallPlayer,lost,lost_game,small,one_pair,100000,100000.0,99990.0,-10.0
35,3422,players_4,AlwaysCallPlayer,won,won_game,big,flush,100000,99990.0,100042.5,52.5
35,3423,players_4,AlwaysCallPlayer,won,won_game,None,full_house,100000,100042.5,100082.5,40.0
35,3424,players_4,AlwaysCallPlayer,lost,lost_game,None,two_pair,100000,100082.5,99272.5,-810.0
35,3425,players_4,AlwaysCallPlayer,won,won_game,None,two_pair,100000,99272.5,99312.5,40.0
35,3426,players_4,AlwaysCallPlayer,lost,lost_game,small,high_card,100000,99312.5,99302.5,-10.0
35,3427,players_4,AlwaysCallPlayer,lost,lost_game,big,two_pair,100000,99302.5,99292.5,-10.0
35,3428,players_4,AlwaysCallPlayer,lost,lost_game,None,two_pair,100000,99292.5,99282.5,-10.0
35,3429,players_4,AlwaysCallPlayer,lost,lost_game,None,one_pair,100000,99282.5,98872.5,-410.0
35,3430,players_4,AlwaysCallPlayer,lost,lost_game,None,two_pair,100000,98872.5,98862.5,-10.0
35,3431,players_4,AlwaysCallPlayer,lost,lost_game,small,full_house,100000,98862.5,98852.5,-10.0
35,3432,players_4,AlwaysCallPlayer,lost,lost_game,big,two_pair,100000,98852.5,98842.5,-10.0
35,3433,players_4,AlwaysCallPlayer,won,won_game,None,one_pair,100000,98842.5,99682.5,840.0
35,3434,players_4,AlwaysCallPlayer,lost,lost_game,None,two_pair,100000,99682.5,99672.5,-10.0
35,3435,players_4,AlwaysCallPlayer,lost,lost_game,None,high_card,100000,99672.5,99662.5,-10.0
35,3436,players_4,AlwaysCallPlayer,lost,lost_game,small,high_card,100000,99662.5,99652.5,-10.0
35,3437,players_4,AlwaysCallPlayer,lost,lost_game,big,high_card,100000,99652.5,99042.5,-610.0
35,3438,players_4,AlwaysCallPlayer,lost,lost_game,None,two_pair,100000,99042.5,99032.5,-10.0
35,3439,players_4,AlwaysCallPlayer,lost,lost_game,None,one_pair,100000,99032.5,98722.5,-310.0
35,3440,players_4,AlwaysCallPlayer,won,won_game,None,three_of_kind,100000,98722.5,98762.5,40.0
35,3441,players_4,AlwaysCallPlayer,won,won_game,small,one_pair,100000,98762.5,98802.5,40.0
35,3442,players_4,AlwaysCallPlayer,lost,lost_game,big,two_pair,100000,98802.5,98592.5,-210.0
35,3443,players_4,AlwaysCallPlayer,lost,lost_game,None,one_pair,100000,98592.5,97982.5,-610.0
35,3444,players_4,AlwaysCallPlayer,lost,lost_game,None,high_card,100000,97982.5,97972.5,-10.0
35,3445,players_4,AlwaysCallPlayer,lost,lost_game,None,high_card,100000,97972.5,97762.5,-210.0
35,3446,players_4,AlwaysCallPlayer,lost,lost_game,small,high_card,100000,97762.5,97152.5,-610.0
35,3447,players_4,AlwaysCallPlayer,lost,lost_game,big,one_pair,100000,97152.5,97042.5,-110.0
35,3448,players_4,AlwaysCallPlayer,won,won_game,None,three_of_kind,100000,97042.5,97082.5,40.0
35,3449,players_4,AlwaysCallPlayer,lost,lost_game,None,two_pair,100000,97082.5,96272.5,-810.0
35,3450,players_4,AlwaysCallPlayer,lost,lost_game,None,high_card,100000,96272.5,96262.5,-10.0
35,3451,players_4,AlwaysCallPlayer,won,won_game,small,flush,100000,96262.5,96277.5,15.0
35,3452,players_4,AlwaysCallPlayer,lost,lost_game,big,two_pair,100000,96277.5,96267.5,-10.0
35,3453,players_4,AlwaysCallPlayer,lost,lost_game,None,one_pair,100000,96267.5,96257.5,-10.0
35,3454,players_4,AlwaysCallPlayer,lost,lost_game,None,two_pair,100000,96257.5,96247.5,-10.0
35,3455,players_4,AlwaysCallPlayer,lost,lost_game,None,high_card,100000,96247.5,96237.5,-10.0
35,3456,players_4,AlwaysCallPlayer,lost,lost_game,small,high_card,100000,96237.5,96227.5,-10.0
35,3457,players_4,AlwaysCallPlayer,lost,lost_game,big,one_pair,100000,96227.5,96217.5,-10.0
35,3458,players_4,AlwaysCallPlayer,lost,lost_game,None,one_pair,100000,96217.5,96107.5,-110.0
35,3459,players_4,AlwaysCallPlayer,lost,lost_game,None,one_pair,100000,96107.5,95997.5,-110.0
35,3460,players_4,AlwaysCallPlayer,won,won_game,None,two_pair,100000,95997.5,96037.5,40.0
35,3461,players_4,AlwaysCallPlayer,lost,lost_game,small,two_pair,100000,96037.5,95827.5,-210.0
35,3462,players_4,AlwaysCallPlayer,lost,lost_game,big,three_of_kind,100000,95827.5,95217.5,-610.0
35,3463,players_4,AlwaysCallPlayer,lost,lost_game,None,one_pair,100000,95217.5,94407.5,-810.0
35,3464,players_4,AlwaysCallPlayer,won,won_game,None,flush,100000,94407.5,94414.16666666667,6.666666666671517
35,3465,players_4,AlwaysCallPlayer,lost,lost_game,None,two_pair,100000,94414.16666666667,94404.16666666667,-10.0
35,3466,players_4,AlwaysCallPlayer,lost,lost_game,small,one_pair,100000,94404.16666666667,94394.16666666667,-10.0
35,3467,players_4,AlwaysCallPlayer,lost,lost_game,big,one_pair,100000,94394.16666666667,93984.16666666667,-410.0
35,3468,players_4,AlwaysCallPlayer,lost,lost_game,None,high_card,100000,93984.16666666667,93974.16666666667,-10.0
35,3469,players_4,AlwaysCallPlayer,lost,lost_game,None,one_pair,100000,93974.16666666667,93264.16666666667,-710.0
35,3470,players_4,AlwaysCallPlayer,lost,lost_game,None,high_card,100000,93264.16666666667,92954.16666666667,-310.0
35,3471,players_4,AlwaysCallPlayer,lost,lost_game,small,high_card,100000,92954.16666666667,92944.16666666667,-10.0
35,3472,players_4,AlwaysCallPlayer,lost,lost_game,big,two_pair,100000,92944.16666666667,92834.16666666667,-110.0
35,3473,players_4,AlwaysCallPlayer,won,won_game,None,three_of_kind,100000,92834.16666666667,92874.16666666667,40.0
35,3474,players_4,AlwaysCallPlayer,lost,lost_game,None,two_pair,100000,92874.16666666667,92864.16666666667,-10.0
35,3475,players_4,AlwaysCallPlayer,lost,lost_game,None,one_pair,100000,92864.16666666667,92654.16666666667,-210.0
35,3476,players_4,AlwaysCallPlayer,lost,lost_game,small,one_pair,100000,92654.16666666667,92644.16666666667,-10.0
35,3477,players_4,AlwaysCallPlayer,won,won_game,big,flush,100000,92644.16666666667,92684.16666666667,40.0
35,3478,players_4,AlwaysCallPlayer,lost,lost_game,None,flush,100000,92684.16666666667,92674.16666666667,-10.0
35,3479,players_4,AlwaysCallPlayer,lost,lost_game,None,two_pair,100000,92674.16666666667,92164.16666666667,-510.0
35,3480,players_4,AlwaysCallPlayer,lost,lost_game,None,one_pair,100000,92164.16666666667,92054.16666666667,-110.0
35,3481,players_4,AlwaysCallPlayer,lost,lost_game,small,one_pair,100000,92054.16666666667,91944.16666666667,-110.0
35,3482,players_4,AlwaysCallPlayer,won,won_game,big,two_pair,100000,91944.16666666667,91984.16666666667,40.0
35,3483,players_4,AlwaysCallPlayer,lost,lost_game,None,high_card,100000,91984.16666666667,91574.16666666667,-410.0
35,3484,players_4,AlwaysCallPlayer,won,won_game,None,flush,100000,91574.16666666667,91614.16666666667,40.0
35,3485,players_4,AlwaysCallPlayer,lost,lost_game,None,one_pair,100000,91614.16666666667,91404.16666666667,-210.0
35,3486,players_4,AlwaysCallPlayer,lost,lost_game,small,high_card,100000,91404.16666666667,91394.16666666667,-10.0
35,3487,players_4,AlwaysCallPlayer,lost,lost_game,big,one_pair,100000,91394.16666666667,91384.16666666667,-10.0
35,3488,players_4,AlwaysCallPlayer,won,won_game,None,straight,100000,91384.16666666667,91424.16666666667,40.0
35,3489,players_4,AlwaysCallPlayer,lost,lost_game,None,high_card,100000,91424.16666666667,91414.16666666667,-10.0
35,3490,players_4,AlwaysCallPlayer,lost,lost_game,None,high_card,100000,91414.16666666667,91204.16666666667,-210.0
35,3491,players_4,AlwaysCallPlayer,lost,lost_game,small,high_card,100000,91204.16666666667,91194.16666666667,-10.0
35,3492,players_4,AlwaysCallPlayer,lost,lost_game,big,one_pair,100000,91194.16666666667,91084.16666666667,-110.0
35,3493,players_4,AlwaysCallPlayer,lost,lost_game,None,one_pair,100000,91084.16666666667,90874.16666666667,-210.0
35,3494,players_4,AlwaysCallPlayer,lost,lost_game,None,two_pair,100000,90874.16666666667,90664.16666666667,-210.0
35,3495,players_4,AlwaysCallPlayer,lost,lost_game,None,two_pair,100000,90664.16666666667,90654.16666666667,-10.0
35,3496,players_4,AlwaysCallPlayer,won,won_game,small,one_pair,100000,90654.16666666667,90694.16666666667,40.0
35,3497,players_4,AlwaysCallPlayer,lost,lost_game,big,high_card,100000,90694.16666666667,89984.16666666667,-710.0
35,3498,players_4,AlwaysCallPlayer,won,won_game,None,one_pair,100000,89984.16666666667,90024.16666666667,40.0
35,3499,players_4,AlwaysCallPlayer,lost,lost_game,None,one_pair,100000,90024.16666666667,89814.16666666667,-210.0
35,3500,players_4,AlwaysCallPlayer,lost,lost_game,None,one_pair,100000,89814.16666666667,89804.16666666667,-10.0
35,3401,players_5,SmartPlayer,lost,fold,big,,100000,100000,99890,-110
35,3402,players_5,SmartPlayer,lost,fold,None,,100000,99890,99880,-10
35,3403,players_5,SmartPlayer,lost,fold,None,,100000,99880,99870,-10
35,3404,players_5,SmartPlayer,lost,fold,None,,100000,99870,99860,-10
35,3405,players_5,SmartPlayer,won,won_game,small,two_pair,100000,99860,101900.0,2040.0
35,3406,players_5,SmartPlayer,lost,lost_game,big,one_pair,100000,101900.0,101190.0,-710.0
35,3407,players_5,SmartPlayer,lost,fold,None,one_pair,100000,101190.0,101180.0,-10.0
35,3408,players_5,SmartPlayer,lost,fold,None,one_pair,100000,101180.0,101170.0,-10.0
35,3409,players_5,SmartPlayer,lost,fold,None,one_pair,100000,101170.0,101160.0,-10.0
35,3410,players_5,SmartPlayer,lost,fold,small,one_pair,100000,101160.0,101150.0,-10.0
35,3411,players_5,SmartPlayer,lost,fold,big,one_pair,100000,101150.0,101140.0,-10.0
35,3412,players_5,SmartPlayer,lost,fold,None,one_pair,100000,101140.0,101130.0,-10.0
35,3413,players_5,SmartPlayer,lost,lost_game,None,one_pair,100000,101130.0,100720.0,-410.0
35,3414,players_5,SmartPlayer,lost,fold,None,one_pair,100000,100720.0,100710.0,-10.0
35,3415,players_5,SmartPlayer,lost,lost_game,small,straight,100000,100710.0,100300.0,-410.0
35,3416,players_5,SmartPlayer,lost,fold,big,straight,100000,100300.0,100290.0,-10.0
35,3417,players_5,SmartPlayer,lost,fold,None,straight,100000,100290.0,100280.0,-10.0
35,3418,players_5,SmartPlayer,lost,fold,None,straight,100000,100280.0,100270.0,-10.0
35,3419,players_5,SmartPlayer,lost,fold,None,straight,100000,100270.0,100260.0,-10.0
35,3420,players_5,SmartPlayer,lost,fold,small,straight,100000,100260.0,100255.0,-5.0
35,3421,players_5,SmartPlayer,lost,fold,big,straight,100000,100255.0,100245.0,-10.0
35,3422,players_5,SmartPlayer,won,won_game,None,flush,100000,100245.0,100297.5,52.5
35,3423,players_5,SmartPlayer,lost,fold,None,flush,100000,100297.5,100287.5,-10.0
35,3424,players_5,SmartPlayer,lost,lost_game,None,three_of_kind,100000,100287.5,99477.5,-810.0
35,3425,players_5,SmartPlayer,lost,fold,small,three_of_kind,100000,99477.5,99467.5,-10.0
35,3426,players_5,SmartPlayer,lost,fold,big,three_of_kind,100000,99467.5,99457.5,-10.0
35,3427,players_5,SmartPlayer,lost,fold,None,three_of_kind,100000,99457.5,99447.5,-10.0
35,3428,players_5,SmartPlayer,lost,fold,None,three_of_kind,100000,99447.5,99437.5,-10.0
35,3429,players_5,SmartPlayer,lost,lost_game,None,flush,100000,99437.5,99027.5,-410.0
35,3430,players_5,SmartPlayer,lost,fold,small,flush,100000,99027.5,99017.5,-10.0
35,3431,players_5,SmartPlayer,lost,fold,big,flush,100000,99017.5,99007.5,-10.0
35,3432,players_5,SmartPlayer,lost,fold,None,flush,100000,99007.5,98997.5,-10.0
35,3433,players_5,SmartPlayer,lost,fold,None,flush,100000,98997.5,98787.5,-210.0
35,3434,players_5,SmartPlayer,lost,fold,None,flush,100000,98787.5,98777.5,-10.0
35,3435,players_5,SmartPlayer,lost,fold,small,flush,100000,98777.5,98767.5,-10.0
35,3436,players_5,SmartPlayer,lost,fold,big,flush,100000,98767.5,98757.5,-10.0
35,3437,players_5,SmartPlayer,won,won_game,None,two_pair,100000,98757.5,101197.5,2440.0
35,3438,players_5,SmartPlayer,lost,fold,None,two_pair,100000,101197.5,101187.5,-10.0
35,3439,players_5,SmartPlayer,lost,fold,None,two_pair,100000,101187.5,100877.5,-310.0
35,3440,players_5,SmartPlayer,lost,fold,small,two_pair,100000,100877.5,100867.5,-10.0
35,3441,players_5,SmartPlayer,lost,fold,big,two_pair,100000,100867.5,100857.5,-10.0
35,3442,players_5,SmartPlayer,lost,fold,None,two_pair,100000,100857.5,100647.5,-210.0
35,3443,players_5,SmartPlayer,won,won_game,None,flush,100000,100647.5,103087.5,2440.0
35,3444,players_5,SmartPlayer,lost,fold,None,flush,100000,103087.5,103077.5,-10.0
35,3445,players_5,SmartPlayer,lost,lost_game,small,one_pair,100000,103077.5,102867.5,-210.0
35,3446,players_5,SmartPlayer,won,won_game,big,flush,100000,102867.5,105307.5,2440.0
35,3447,players_5,SmartPlayer,lost,fold,None,flush,100000,105307.5,105197.5,-110.0
35,3448,players_5,SmartPlayer,lost,fold,None,flush,100000,105197.5,105187.5,-10.0
35,3449,players_5,SmartPlayer,won,won_game,None,two_pair,100000,105187.5,108427.5,3240.0
35,3450,players_5,SmartPlayer,lost,fold,small,two_pair,100000,108427.5,108417.5,-10.0
35,3451,players_5,SmartPlayer,lost,fold,big,two_pair,100000,108417.5,108407.5,-10.0
35,3452,players_5,SmartPlayer,lost,fold,None,two_pair,100000,108407.5,108397.5,-10.0
35,3453,players_5,SmartPlayer,lost,fold,None,two_pair,100000,108397.5,108387.5,-10.0
35,3454,players_5,SmartPlayer,lost,fold,None,two_pair,100000,108387.5,108377.5,-10.0
35,3455,players_5,SmartPlayer,lost,fold,small,two_pair,100000,108377.5,108367.5,-10.0
35,3456,players_5,SmartPlayer,lost,fold,big,two_pair,100000,108367.5,108357.5,-10.0
35,3457,players_5,SmartPlayer,lost,fold,None,two_pair,100000,108357.5,108347.5,-10.0
35,3458,players_5,SmartPlayer,lost,lost_game,None,two_pair,100000,108347.5,108237.5,-110.0
35,3459,players_5,SmartPlayer,lost,fold,None,two_pair,100000,108237.5,108127.5,-110.0
35,3460,players_5,SmartPlayer,lost,fold,small,two_pair,100000,108127.5,108117.5,-10.0
35,3461,players_5,SmartPlayer,lost,fold,big,two_pair,100000,108117.5,107907.5,-210.0
35,3462,players_5,SmartPlayer,won,won_game,None,four_of_kind,100000,107907.5,110347.5,2440.0
35,3463,players_5,SmartPlayer,won,won_game,None,straight,100000,110347.5,113587.5,3240.0
35,3464,players_5,SmartPlayer,lost,fold,None,straight,100000,113587.5,113577.5,-10.0
35,3465,players_5,SmartPlayer,lost,fold,small,straight,100000,113577.5,113567.5,-10.0
35,3466,players_5,SmartPlayer,lost,fold,big,straight,100000,113567.5,113557.5,-10.0
35,3467,players_5,SmartPlayer,won,won_game,None,straight,100000,113557.5,114172.5,615.0
35,3468,players_5,SmartPlayer,lost,fold,None,straight,100000,114172.5,114162.5,-10.0
35,3469,players_5,SmartPlayer,lost,lost_game,None,two_pair,100000,114162.5,113452.5,-710.0
35,3470,players_5,SmartPlayer,lost,lost_game,small,one_pair,100000,113452.5,113142.5,-310.0
35,3471,players_5,SmartPlayer,lost,fold,big,one_pair,100000,113142.5,113132.5,-10.0
35,3472,players_5,SmartPlayer,lost,fold,None,one_pair,100000,113132.5,113022.5,-110.0
35,3473,players_5,SmartPlayer,lost,fold,None,one_pair,100000,113022.5,113012.5,-10.0
35,3474,players_5,SmartPlayer,lost,fold,None,one_pair,100000,113012.5,113002.5,-10.0
35,3475,players_5,SmartPlayer,lost,fold,small,one_pair,100000,113002.5,112792.5,-210.0
35,3476,players_5,SmartPlayer,lost,fold,big,one_pair,100000,112792.5,112782.5,-10.0
35,3477,players_5,SmartPlayer,lost,fold,None,one_pair,100000,112782.5,112772.5,-10.0
35,3478,players_5,SmartPlayer,lost,fold,None,one_pair,100000,112772.5,112762.5,-10.0
35,3479,players_5,SmartPlayer,lost,lost_game,None,two_pair,100000,112762.5,112252.5,-510.0
35,3480,players_5,SmartPlayer,lost,fold,small,two_pair,100000,112252.5,112142.5,-110.0
35,3481,players_5,SmartPlayer,lost,fold,big,two_pair,100000,112142.5,112032.5,-110.0
35,3482,players_5,SmartPlayer,lost,fold,None,two_pair,100000,112032.5,112022.5,-10.0
35,3483,players_5,SmartPlayer,won,won_game,None,one_pair,100000,112022.5,112637.5,615.0
35,3484,players_5,SmartPlayer,lost,fold,None,one_pair,100000,112637.5,112627.5,-10.0
35,3485,players_5,SmartPlayer,lost,fold,small,one_pair,100000,112627.5,112417.5,-210.0
35,3486,players_5,SmartPlayer,lost,fold,big,one_pair,100000,112417.5,112407.5,-10.0
35,3487,players_5,SmartPlayer,lost,fold,None,one_pair,100000,112407.5,112397.5,-10.0
35,3488,players_5,SmartPlayer,lost,fold,None,one_pair,100000,112397.5,112387.5,-10.0
35,3489,players_5,SmartPlayer,lost,fold,None,one_pair,100000,112387.5,112377.5,-10.0
35,3490,players_5,SmartPlayer,lost,fold,small,one_pair,100000,112377.5,112167.5,-210.0
35,3491,players_5,SmartPlayer,lost,fold,big,one_pair,100000,112167.5,112157.5,-10.0
35,3492,players_5,SmartPlayer,lost,fold,None,one_pair,100000,112157.5,112047.5,-110.0
35,3493,players_5,SmartPlayer,lost,fold,None,one_pair,100000,112047.5,111837.5,-210.0
35,3494,players_5,SmartPlayer,lost,fold,None,one_pair,100000,111837.5,111627.5,-210.0
35,3495,players_5,SmartPlayer,lost,fold,small,one_pair,100000,111627.5,111617.5,-10.0
35,3496,players_5,SmartPlayer,lost,fold,big,one_pair,100000,111617.5,111607.5,-10.0
35,3497,players_5,SmartPlayer,lost,lost_game,None,two_pair,100000,111607.5,110897.5,-710.0
35,3498,players_5,SmartPlayer,lost,fold,None,two_pair,100000,110897.5,110887.5,-10.0
35,3499,players_5,SmartPlayer,lost,fold,None,two_pair,100000,110887.5,110677.5,-210.0
35,3500,players_5,SmartPlayer,lost,fold,small,two_pair,100000,110677.5,110667.5,-10.0
