table_id,game_id,player_name,player_type,game_result,game_reason,blind_type,final_hand,beginning_balance,game_start_balance,game_end_balance,game_net_change
28,2701,players_1,AlwaysCallPlayer,lost,lost_game,None,high_card,100000,100000,99990,-10
28,2702,players_1,AlwaysCallPlayer,lost,lost_game,None,one_pair,100000,99990,99980,-10
28,2703,players_1,AlwaysCallPlayer,lost,lost_game,small,one_pair,100000,99980,99970,-10
28,2704,players_1,AlwaysCallPlayer,lost,lost_game,big,two_pair,100000,99970,99660,-310
28,2705,players_1,AlwaysCallPlayer,lost,lost_game,None,one_pair,100000,99660,99050,-610
28,2706,players_1,AlwaysCallPlayer,won,won_game,None,straight,100000,99050,99080.0,30.0
28,2707,players_1,AlwaysCallPlayer,lost,lost_game,small,one_pair,100000,99080.0,98770.0,-310.0
28,2708,players_1,AlwaysCallPlayer,lost,lost_game,big,high_card,100000,98770.0,98760.0,-10.0
28,2709,players_1,AlwaysCallPlayer,won,won_game,None,one_pair,100000,98760.0,98790.0,30.0
28,2710,players_1,AlwaysCallPlayer,lost,lost_game,None,high_card,100000,98790.0,98780.0,-10.0
28,2711,players_1,AlwaysCallPlayer,won,won_game,small,one_pair,100000,98780.0,98810.0,30.0
28,2712,players_1,AlwaysCallPlayer,lost,lost_game,big,one_pair,100000,98810.0,98800.0,-10.0
28,2713,players_1,AlwaysCallPlayer,won,won_game,None,flush,100000,98800.0,98830.0,30.0
28,2714,players_1,AlwaysCallPlayer,won,won_game,None,two_pair,100000,98830.0,98860.0,30.0
28,2715,players_1,AlwaysCallPlayer,won,won_game,small,three_of_kind,100000,98860.0,98890.0,30.0
28,2716,players_1,AlwaysCallPlayer,lost,lost_game,big,high_card,100000,98890.0,98880.0,-10.0
28,2717,players_1,AlwaysCallPlayer,lost,lost_game,None,one_pair,100000,98880.0,98870.0,-10.0
28,2718,players_1,AlwaysCallPlayer,lost,lost_game,None,high_card,100000,98870.0,98460.0,-410.0
28,2719,players_1,AlwaysCallPlayer,lost,lost_game,small,one_pair,100000,98460.0,98450.0,-10.0
28,2720,players_1,AlwaysCallPlayer,lost,lost_game,big,high_card,100000,98450.0,98140.0,-310.0
28,2721,players_1,AlwaysCallPlayer,lost,lost_game,None,one_pair,100000,98140.0,98130.0,-10.0
28,2722,players_1,AlwaysCallPlayer,won,won_game,None,two_pair,100000,98130.0,98160.0,30.0
28,2723,players_1,AlwaysCallPlayer,lost,lost_game,small,one_pair,100000,98160.0,98150.0,-10.0
28,2724,players_1,AlwaysCallPlayer,lost,lost_game,big,one_pair,100000,98150.0,98140.0,-10.0
28,2725,players_1,AlwaysCallPlayer,lost,lost_game,None,high_card,100000,98140.0,98130.0,-10.0
28,2726,players_1,AlwaysCallPlayer,lost,lost_game,None,one_pair,100000,98130.0,98020.0,-110.0
28,2727,players_1,AlwaysCallPlayer,lost,lost_game,small,one_pair,100000,98020.0,98010.0,-10.0
28,2728,players_1,AlwaysCallPlayer,won,won_game,big,one_pair,100000,98010.0,98040.0,30.0
28,2729,players_1,AlwaysCallPlayer,lost,lost_game,None,two_pair,100000,98040.0,97230.0,-810.0
28,2730,players_1,AlwaysCallPlayer,lost,lost_game,None,high_card,100000,97230.0,97220.0,-10.0
28,2731,players_1,AlwaysCallPlayer,won,won_game,small,three_of_kind,100000,97220.0,97230.0,10.0
28,2732,players_1,AlwaysCallPlayer,lost,lost_game,big,one_pair,100000,97230.0,96920.0,-310.0
28,2733,players_1,AlwaysCallPlayer,won,won_game,None,three_of_kind,100000,96920.0,96950.0,30.0
28,2734,players_1,AlwaysCallPlayer,lost,lost_game,None,one_pair,100000,96950.0,96840.0,-110.0
28,2735,players_1,AlwaysCallPlayer,won,won_game,small,one_pair,100000,96840.0,97170.0,330.0
28,2736,players_1,AlwaysCallPlayer,won,won_game,big,one_pair,100000,97170.0,97200.0,30.0
28,2737,players_1,AlwaysCallPlayer,won,won_game,None,straight,100000,97200.0,97230.0,30.0
28,2738,players_1,AlwaysCallPlayer,lost,lost_game,None,high_card,100000,97230.0,96520.0,-710.0
28,2739,players_1,AlwaysCallPlayer,lost,lost_game,small,two_pair,100000,96520.0,96210.0,-310.0
28,2740,players_1,AlwaysCallPlayer,won,won_game,big,straight,100000,96210.0,96240.0,30.0
28,2741,players_1,AlwaysCallPlayer,lost,lost_game,None,one_pair,100000,96240.0,95830.0,-410.0
28,2742,players_1,AlwaysCallPlayer,won,won_game,None,one_pair,100000,95830.0,97060.0,1230.0
28,2743,players_1,AlwaysCallPlayer,lost,lost_game,small,high_card,100000,97060.0,97050.0,-10.0
28,2744,players_1,AlwaysCallPlayer,lost,lost_game,big,one_pair,100000,97050.0,96540.0,-510.0
28,2745,players_1,AlwaysCallPlayer,won,won_game,None,two_pair,100000,96540.0,96570.0,30.0
28,2746,players_1,AlwaysCallPlayer,lost,lost_game,None,one_pair,100000,96570.0,96560.0,-10.0
28,2747,players_1,AlwaysCallPlayer,lost,lost_game,small,one_pair,100000,96560.0,96550.0,-10.0
28,2748,players_1,AlwaysCallPlayer,lost,lost_game,big,one_pair,100000,96550.0,96540.0,-10.0
28,2749,players_1,AlwaysCallPlayer,lost,lost_game,None,two_pair,100000,96540.0,95730.0,-810.0
28,2750,players_1,AlwaysCallPlayer,lost,lost_game,None,high_card,100000,95730.0,95720.0,-10.0
28,2751,players_1,AlwaysCallPlayer,lost,lost_game,small,one_pair,100000,95720.0,95710.0,-10.0
28,2752,players_1,AlwaysCallPlayer,lost,lost_game,big,one_pair,100000,95710.0,95500.0,-210.0
28,2753,players_1,AlwaysCallPlayer,lost,lost_game,None,three_of_kind,100000,95500.0,95490.0,-10.0
28,2754,players_1,AlwaysCallPlayer,won,won_game,None,straight,100000,95490.0,95900.0,410.0
28,2755,players_1,AlwaysCallPlayer,lost,lost_game,small,one_pair,100000,95900.0,95890.0,-10.0
28,2756,players_1,AlwaysCallPlayer,lost,lost_game,big,high_card,100000,95890.0,95880.0,-10.0
28,2757,players_1,AlwaysCallPlayer,lost,lost_game,None,one_pair,100000,95880.0,95870.0,-10.0
28,2758,players_1,AlwaysCallPlayer,lost,lost_game,None,one_pair,100000,95870.0,95860.0,-10.0
28,2759,players_1,AlwaysCallPlayer,won,won_game,small,two_pair,100000,95860.0,95890.0,30.0
28,2760,players_1,AlwaysCallPlayer,lost,lost_game,big,one_pair,100000,95890.0,95780.0,-110.0
28,2761,players_1,AlwaysCallPlayer,lost,lost_game,None,two_pair,100000,95780.0,95770.0,-10.0
28,2762,players_1,AlwaysCallPlayer,lost,lost_game,None,one_pair,100000,95770.0,95760.0,-10.0
28,2763,players_1,AlwaysCallPlayer,lost,lost_game,small,two_pair,100000,95760.0,95150.0,-610.0
28,2764,players_1,AlwaysCallPlayer,lost,lost_game,big,one_pair,100000,95150.0,95140.0,-10.0
28,2765,players_1,AlwaysCallPlayer,won,won_game,None,one_pair,100000,95140.0,95170.0,30.0
28,2766,players_1,AlwaysCallPlayer,lost,lost_game,None,high_card,100000,95170.0,95160.0,-10.0
28,2767,players_1,AlwaysCallPlayer,won,won_game,small,flush,100000,95160.0,96090.0,930.0
28,2768,players_1,AlwaysCallPlayer,lost,lost_game,big,one_pair,100000,96090.0,96080.0,-10.0
28,2769,players_1,AlwaysCallPlayer,won,won_game,None,full_house,100000,96080.0,96110.0,30.0
28,2770,players_1,AlwaysCallPlayer,lost,lost_game,None,two_pair,100000,96110.0,95400.0,-710.0
28,2771,players_1,AlwaysCallPlayer,won,won_game,small,two_pair,100000,95400.0,95430.0,30.0
28,2772,players_1,AlwaysCallPlayer,lost,lost_game,big,high_card,100000,95430.0,95120.0,-310.0
28,2773,players_1,AlwaysCallPlayer,lost,lost_game,None,one_pair,100000,95120.0,95110.0,-10.0
28,2774,players_1,AlwaysCallPlayer,won,won_game,None,straight,100000,95110.0,96940.0,1830.0
28,2775,players_1,AlwaysCallPlayer,lost,lost_game,small,one_pair,100000,96940.0,96130.0,-810.0
28,2776,players_1,AlwaysCallPlayer,lost,lost_game,big,straight,100000,96130.0,95920.0,-210.0
28,2777,players_1,AlwaysCallPlayer,lost,lost_game,None,one_pair,100000,95920.0,95910.0,-10.0
28,2778,players_1,AlwaysCallPlayer,lost,lost_game,None,high_card,100000,95910.0,95400.0,-510.0
28,2779,players_1,AlwaysCallPlayer,lost,lost_game,small,one_pair,100000,95400.0,95390.0,-10.0
28,2780,players_1,AlwaysCallPlayer,won,won_game,big,one_pair,100000,95390.0,95420.0,30.0
28,2781,players_1,AlwaysCallPlayer,lost,lost_game,None,two_pair,100000,95420.0,94910.0,-510.0
28,2782,players_1,AlwaysCallPlayer,won,won_game,None,flush,100000,94910.0,94940.0,30.0
28,2783,players_1,AlwaysCallPlayer,lost,lost_game,small,two_pair,100000,94940.0,94930.0,-10.0
28,2784,players_1,AlwaysCallPlayer,lost,lost_game,big,one_pair,100000,94930.0,94920.0,-10.0
28,2785,players_1,AlwaysCallPlayer,lost,lost_game,None,two_pair,100000,94920.0,94910.0,-10.0
28,2786,players_1,AlwaysCallPlayer,won,won_game,None,one_pair,100000,94910.0,94940.0,30.0
28,2787,players_1,AlwaysCallPlayer,lost,lost_game,small,high_card,100000,94940.0,94130.0,-810.0
28,2788,players_1,AlwaysCallPlayer,won,won_game,big,three_of_kind,100000,94130.0,94160.0,30.0
28,2789,players_1,AlwaysCallPlayer,won,won_game,None,two_pair,100000,94160.0,94190.0,30.0
28,2790,players_1,AlwaysCallPlayer,won,won_game,None,straight,100000,94190.0,95420.0,1230.0
28,2791,players_1,AlwaysCallPlayer,lost,lost_game,small,high_card,100000,95420.0,95410.0,-10.0
28,2792,players_1,AlwaysCallPlayer,won,won_game,big,two_pair,100000,95410.0,95440.0,30.0
28,2793,players_1,AlwaysCallPlayer,lost,lost_game,None,two_pair,100000,95440.0,95130.0,-310.0
28,2794,players_1,AlwaysCallPlayer,lost,lost_game,None,high_card,100000,95130.0,94620.0,-510.0
28,2795,players_1,AlwaysCallPlayer,lost,lost_game,small,one_pair,100000,94620.0,94610.0,-10.0
28,2796,players_1,AlwaysCallPlayer,lost,lost_game,big,one_pair,100000,94610.0,94100.0,-510.0
28,2797,players_1,AlwaysCallPlayer,lost,lost_game,None,high_card,100000,94100.0,94090.0,-10.0
28,2798,players_1,AlwaysCallPlayer,lost,lost_game,None,two_pair,100000,94090.0,94080.0,-10.0
28,2799,players_1,AlwaysCallPlayer,won,won_game,small,one_pair,100000,94080.0,94110.0,30.0
28,2800,players_1,AlwaysCallPlayer,lost,lost_game,big,one_pair,100000,94110.0,93600.0,-510.0
28,2701,players_2,AlwaysCallPlayer,won,won_game,None,one_pair,100000,100000,100030.0,30.0
28,2702,players_2,AlwaysCallPlayer,won,won_game,small,one_pair,100000,100030.0,100060.0,30.0
28,2703,players_2,AlwaysCallPlayer,lost,lost_game,big,one_pair,100000,100060.0,100050.0,-10.0
28,2704,players_2,AlwaysCallPlayer,lost,lost_game,None,one_pair,100000,100050.0,99740.0,-310.0
28,2705,players_2,AlwaysCallPlayer,won,won_game,None,straight,100000,99740.0,100350.0,610.0
28,2706,players_2,AlwaysCallPlayer,lost,lost_game,small,two_pair,100000,100350.0,100340.0,-10.0
28,2707,players_2,AlwaysCallPlayer,lost,lost_game,big,high_card,100000,100340.0,100030.0,-310.0
28,2708,players_2,AlwaysCallPlayer,lost,lost_game,None,high_card,100000,100030.0,100020.0,-10.0
28,2709,players_2,AlwaysCallPlayer,lost,lost_game,None,one_pair,100000,100020.0,100010.0,-10.0
28,2710,players_2,AlwaysCallPlayer,won,won_game,small,straight,100000,100010.0,100040.0,30.0
28,2711,players_2,AlwaysCallPlayer,lost,lost_game,big,one_pair,100000,100040.0,100030.0,-10.0
28,2712,players_2,AlwaysCallPlayer,won,won_game,None,two_pair,100000,100030.0,100060.0,30.0
28,2713,players_2,AlwaysCallPlayer,lost,lost_game,None,three_of_kind,100000,100060.0,100050.0,-10.0
28,2714,players_2,AlwaysCallPlayer,lost,lost_game,small,high_card,100000,100050.0,100040.0,-10.0
28,2715,players_2,AlwaysCallPlayer,lost,lost_game,big,one_pair,100000,100040.0,100030.0,-10.0
28,2716,players_2,AlwaysCallPlayer,won,won_game,None,two_pair,100000,100030.0,100060.0,30.0
28,2717,players_2,AlwaysCallPlayer,lost,lost_game,None,one_pair,100000,100060.0,100050.0,-10.0
28,2718,players_2,AlwaysCallPlayer,lost,lost_game,small,high_card,100000,100050.0,99640.0,-410.0
28,2719,players_2,AlwaysCallPlayer,lost,lost_game,big,one_pair,100000,99640.0,99630.0,-10.0
28,2720,players_2,AlwaysCallPlayer,lost,lost_game,None,high_card,100000,99630.0,99320.0,-310.0
28,2721,players_2,AlwaysCallPlayer,won,won_game,None,two_pair,100000,99320.0,99350.0,30.0
28,2722,players_2,AlwaysCallPlayer,lost,lost_game,small,high_card,100000,99350.0,99340.0,-10.0
28,2723,players_2,AlwaysCallPlayer,won,won_game,big,one_pair,100000,99340.0,99370.0,30.0
28,2724,players_2,AlwaysCallPlayer,won,won_game,None,two_pair,100000,99370.0,99400.0,30.0
28,2725,players_2,AlwaysCallPlayer,won,won_game,None,high_card,100000,99400.0,99430.0,30.0
28,2726,players_2,AlwaysCallPlayer,lost,lost_game,small,one_pair,100000,99430.0,99320.0,-110.0
28,2727,players_2,AlwaysCallPlayer,won,won_game,big,flush,100000,99320.0,99350.0,30.0
28,2728,players_2,AlwaysCallPlayer,lost,lost_game,None,one_pair,100000,99350.0,99340.0,-10.0
28,2729,players_2,AlwaysCallPlayer,lost,lost_game,None,one_pair,100000,99340.0,98530.0,-810.0
28,2730,players_2,AlwaysCallPlayer,won,won_game,small,one_pair,100000,98530.0,98560.0,30.0
28,2731,players_2,AlwaysCallPlayer,lost,lost_game,big,one_pair,100000,98560.0,98550.0,-10.0
28,2732,players_2,AlwaysCallPlayer,won,won_game,None,flush,100000,98550.0,99480.0,930.0
28,2733,players_2,AlwaysCallPlayer,lost,lost_game,None,one_pair,100000,99480.0,99470.0,-10.0
28,2734,players_2,AlwaysCallPlayer,lost,lost_game,small,one_pair,100000,99470.0,99360.0,-110.0
28,2735,players_2,AlwaysCallPlayer,lost,lost_game,big,one_pair,100000,99360.0,99250.0,-110.0
28,2736,players_2,AlwaysCallPlayer,lost,lost_game,None,high_card,100000,99250.0,99240.0,-10.0
28,2737,players_2,AlwaysCallPlayer,lost,lost_game,None,one_pair,100000,99240.0,99230.0,-10.0
28,2738,players_2,AlwaysCallPlayer,won,won_game,small,flush,100000,99230.0,101360.0,2130.0
28,2739,players_2,AlwaysCallPlayer,won,won_game,big,full_house,100000,101360.0,102290.0,930.0
28,2740,players_2,AlwaysCallPlayer,lost,lost_game,None,one_pair,100000,102290.0,102280.0,-10.0
28,2741,players_2,AlwaysCallPlayer,won,won_game,None,two_pair,100000,102280.0,103510.0,1230.0
28,2742,players_2,AlwaysCallPlayer,lost,lost_game,small,high_card,100000,103510.0,103100.0,-410.0
28,2743,players_2,AlwaysCallPlayer,lost,lost_game,big,one_pair,100000,103100.0,103090.0,-10.0
28,2744,players_2,AlwaysCallPlayer,lost,lost_game,None,high_card,100000,103090.0,102580.0,-510.0
28,2745,players_2,AlwaysCallPlayer,lost,lost_game,None,two_pair,100000,102580.0,102570.0,-10.0
28,2746,players_2,AlwaysCallPlayer,won,won_game,small,two_pair,100000,102570.0,102600.0,30.0
28,2747,players_2,AlwaysCallPlayer,lost,lost_game,big,one_pair,100000,102600.0,102590.0,-10.0
28,2748,players_2,AlwaysCallPlayer,won,won_game,None,one_pair,100000,102590.0,102600.0,10.0
28,2749,players_2,AlwaysCallPlayer,lost,lost_game,None,one_pair,100000,102600.0,101790.0,-810.0
28,2750,players_2,AlwaysCallPlayer,won,won_game,small,straight,100000,101790.0,101820.0,30.0
28,2751,players_2,AlwaysCallPlayer,won,won_game,big,two_pair,100000,101820.0,101850.0,30.0
28,2752,players_2,AlwaysCallPlayer,lost,lost_game,None,high_card,100000,101850.0,101640.0,-210.0
28,2753,players_2,AlwaysCallPlayer,won,won_game,None,three_of_kind,100000,101640.0,101670.0,30.0
28,2754,players_2,AlwaysCallPlayer,lost,lost_game,small,one_pair,100000,101670.0,101260.0,-410.0
28,2755,players_2,AlwaysCallPlayer,won,won_game,big,one_pair,100000,101260.0,101290.0,30.0
28,2756,players_2,AlwaysCallPlayer,lost,lost_game,None,high_card,100000,101290.0,101280.0,-10.0
28,2757,players_2,AlwaysCallPlayer,won,won_game,None,one_pair,100000,101280.0,101310.0,30.0
28,2758,players_2,AlwaysCallPlayer,lost,lost_game,small,one_pair,100000,101310.0,101300.0,-10.0
28,2759,players_2,AlwaysCallPlayer,lost,lost_game,big,one_pair,100000,101300.0,101290.0,-10.0
28,2760,players_2,AlwaysCallPlayer,lost,lost_game,None,one_pair,100000,101290.0,101180.0,-110.0
28,2761,players_2,AlwaysCallPlayer,lost,lost_game,None,one_pair,100000,101180.0,101170.0,-10.0
28,2762,players_2,AlwaysCallPlayer,won,won_game,small,two_pair,100000,101170.0,101200.0,30.0
28,2763,players_2,AlwaysCallPlayer,lost,lost_game,big,two_pair,100000,101200.0,100590.0,-610.0
28,2764,players_2,AlwaysCallPlayer,lost,lost_game,None,high_card,100000,100590.0,100580.0,-10.0
28,2765,players_2,AlwaysCallPlayer,lost,lost_game,None,high_card,100000,100580.0,100570.0,-10.0
28,2766,players_2,AlwaysCallPlayer,lost,lost_game,small,high_card,100000,100570.0,100560.0,-10.0
28,2767,players_2,AlwaysCallPlayer,lost,lost_game,big,one_pair,100000,100560.0,100250.0,-310.0
28,2768,players_2,AlwaysCallPlayer,won,won_game,None,one_pair,100000,100250.0,100280.0,30.0
28,2769,players_2,AlwaysCallPlayer,lost,lost_game,None,full_house,100000,100280.0,100270.0,-10.0
28,2770,players_2,AlwaysCallPlayer,lost,lost_game,small,one_pair,100000,100270.0,99560.0,-710.0
28,2771,players_2,AlwaysCallPlayer,lost,lost_game,big,one_pair,100000,99560.0,99550.0,-10.0
28,2772,players_2,AlwaysCallPlayer,lost,lost_game,None,high_card,100000,99550.0,99240.0,-310.0
28,2773,players_2,AlwaysCallPlayer,won,won_game,None,one_pair,100000,99240.0,99270.0,30.0
28,2774,players_2,AlwaysCallPlayer,lost,lost_game,small,high_card,100000,99270.0,98660.0,-610.0
28,2775,players_2,AlwaysCallPlayer,lost,lost_game,big,two_pair,100000,98660.0,97850.0,-810.0
28,2776,players_2,AlwaysCallPlayer,lost,lost_game,None,one_pair,100000,97850.0,97640.0,-210.0
28,2777,players_2,AlwaysCallPlayer,won,won_game,None,one_pair,100000,97640.0,97670.0,30.0
28,2778,players_2,AlwaysCallPlayer,lost,lost_game,small,high_card,100000,97670.0,97160.0,-510.0
28,2779,players_2,AlwaysCallPlayer,won,won_game,big,two_pair,100000,97160.0,97190.0,30.0
28,2780,players_2,AlwaysCallPlayer,lost,lost_game,None,high_card,100000,97190.0,97180.0,-10.0
28,2781,players_2,AlwaysCallPlayer,lost,lost_game,None,two_pair,100000,97180.0,96670.0,-510.0
28,2782,players_2,AlwaysCallPlayer,lost,lost_game,small,one_pair,100000,96670.0,96660.0,-10.0
28,2783,players_2,AlwaysCallPlayer,won,won_game,big,three_of_kind,100000,96660.0,96690.0,30.0
28,2784,players_2,AlwaysCallPlayer,won,won_game,None,one_pair,100000,96690.0,96720.0,30.0
28,2785,players_2,AlwaysCallPlayer,lost,lost_game,None,two_pair,100000,96720.0,96710.0,-10.0
28,2786,players_2,AlwaysCallPlayer,lost,lost_game,small,high_card,100000,96710.0,96700.0,-10.0
28,2787,players_2,AlwaysCallPlayer,won,won_game,big,three_of_kind,100000,96700.0,99130.0,2430.0
28,2788,players_2,AlwaysCallPlayer,lost,lost_game,None,one_pair,100000,99130.0,99120.0,-10.0
28,2789,players_2,AlwaysCallPlayer,lost,lost_game,None,two_pair,100000,99120.0,99110.0,-10.0
28,2790,players_2,AlwaysCallPlayer,lost,lost_game,small,one_pair,100000,99110.0,98700.0,-410.0
28,2791,players_2,AlwaysCallPlayer,won,won_game,big,one_pair,100000,98700.0,98730.0,30.0
28,2792,players_2,AlwaysCallPlayer,lost,lost_game,None,one_pair,100000,98730.0,98720.0,-10.0
28,2793,players_2,AlwaysCallPlayer,lost,lost_game,None,two_pair,100000,98720.0,98410.0,-310.0
28,2794,players_2,AlwaysCallPlayer,lost,lost_game,small,one_pair,100000,98410.0,97900.0,-510.0
28,2795,players_2,AlwaysCallPlayer,won,won_game,big,one_pair,100000,97900.0,97930.0,30.0
28,2796,players_2,AlwaysCallPlayer,lost,lost_game,None,high_card,100000,97930.0,97420.0,-510.0
28,2797,players_2,AlwaysCallPlayer,lost,lost_game,None,one_pair,100000,97420.0,97410.0,-10.0
28,2798,players_2,AlwaysCallPlayer,lost,lost_game,small,one_pair,100000,97410.0,97400.0,-10.0
28,2799,players_2,AlwaysCallPlayer,lost,lost_game,big,one_pair,100000,97400.0,97390.0,-10.0
28,2800,players_2,AlwaysCallPlayer,lost,lost_game,None,high_card,100000,97390.0,96880.0,-510.0
28,2701,players_3,AlwaysCallPlayer,lost,lost_game,small,one_pair,100000,100000,99990,-10
28,2702,players_3,AlwaysCallPlayer,lost,lost_game,big,high_card,100000,99990,99980,-10
28,2703,players_3,AlwaysCallPlayer,won,won_game,None,two_pair,100000,99980,100010.0,30.0
28,2704,players_3,AlwaysCallPlayer,lost,lost_game,None,one_pair,100000,100010.0,99700.0,-310.0
28,2705,players_3,AlwaysCallPlayer,lost,lost_game,small,one_pair,100000,99700.0,99090.0,-610.0
28,2706,players_3,AlwaysCallPlayer,lost,lost_game,big,two_pair,100000,99090.0,99080.0,-10.0
28,2707,players_3,AlwaysCallPlayer,won,won_game,None,one_pair,100000,99080.0,100010.0,930.0
28,2708,players_3,AlwaysCallPlayer,won,won_game,None,one_pair,100000,100010.0,100040.0,30.0
28,2709,players_3,AlwaysCallPlayer,lost,lost_game,small,one_pair,100000,100040.0,100030.0,-10.0
28,2710,players_3,AlwaysCallPlayer,lost,lost_game,big,three_of_kind,100000,100030.0,100020.0,-10.0
28,2711,players_3,AlwaysCallPlayer,lost,lost_game,None,one_pair,100000,100020.0,100010.0,-10.0
28,2712,players_3,AlwaysCallPlayer,lost,lost_game,None,one_pair,100000,100010.0,100000.0,-10.0
28,2713,players_3,AlwaysCallPlayer,lost,lost_game,small,one_pair,100000,100000.0,99990.0,-10.0
28,2714,players_3,AlwaysCallPlayer,lost,lost_game,big,high_card,100000,99990.0,99980.0,-10.0
28,2715,players_3,AlwaysCallPlayer,lost,lost_game,None,one_pair,100000,99980.0,99970.0,-10.0
28,2716,players_3,AlwaysCallPlayer,lost,lost_game,None,one_pair,100000,99970.0,99960.0,-10.0
28,2717,players_3,AlwaysCallPlayer,won,won_game,small,two_pair,100000,99960.0,99990.0,30.0
28,2718,players_3,AlwaysCallPlayer,lost,lost_game,big,high_card,100000,99990.0,99580.0,-410.0
28,2719,players_3,AlwaysCallPlayer,won,won_game,None,two_pair,100000,99580.0,99610.0,30.0
28,2720,players_3,AlwaysCallPlayer,lost,lost_game,None,high_card,100000,99610.0,99300.0,-310.0
28,2721,players_3,AlwaysCallPlayer,lost,lost_game,small,high_card,100000,99300.0,99290.0,-10.0
28,2722,players_3,AlwaysCallPlayer,lost,lost_game,big,high_card,100000,99290.0,99280.0,-10.0
28,2723,players_3,AlwaysCallPlayer,lost,lost_game,None,one_pair,100000,99280.0,99270.0,-10.0
28,2724,players_3,AlwaysCallPlayer,lost,lost_game,None,one_pair,100000,99270.0,99260.0,-10.0
28,2725,players_3,AlwaysCallPlayer,lost,lost_game,small,high_card,100000,99260.0,99250.0,-10.0
28,2726,players_3,AlwaysCallPlayer,won,won_game,big,two_pair,100000,99250.0,99580.0,330.0
28,2727,players_3,AlwaysCallPlayer,lost,lost_game,None,one_pair,100000,99580.0,99570.0,-10.0
28,2728,players_3,AlwaysCallPlayer,lost,lost_game,None,high_card,100000,99570.0,99560.0,-10.0
28,2729,players_3,AlwaysCallPlayer,lost,lost_game,small,one_pair,100000,99560.0,98750.0,-810.0
28,2730,players_3,AlwaysCallPlayer,lost,lost_game,big,one_pair,100000,98750.0,98740.0,-10.0
28,2731,players_3,AlwaysCallPlayer,won,won_game,None,three_of_kind,100000,98740.0,98750.0,10.0
28,2732,players_3,AlwaysCallPlayer,lost,lost_game,None,high_card,100000,98750.0,98440.0,-310.0
28,2733,players_3,AlwaysCallPlayer,lost,lost_game,small,one_pair,100000,98440.0,98430.0,-10.0
28,2734,players_3,AlwaysCallPlayer,lost,lost_game,big,two_pair,100000,98430.0,98320.0,-110.0
28,2735,players_3,AlwaysCallPlayer,lost,lost_game,None,high_card,100000,98320.0,98210.0,-110.0
28,2736,players_3,AlwaysCallPlayer,lost,lost_game,None,high_card,100000,98210.0,98200.0,-10.0
28,2737,players_3,AlwaysCallPlayer,lost,lost_game,small,two_pair,100000,98200.0,98190.0,-10.0
28,2738,players_3,AlwaysCallPlayer,lost,lost_game,big,one_pair,100000,98190.0,97480.0,-710.0
28,2739,players_3,AlwaysCallPlayer,lost,lost_game,None,two_pair,100000,97480.0,97170.0,-310.0
28,2740,players_3,AlwaysCallPlayer,lost,lost_game,None,two_pair,100000,97170.0,97160.0,-10.0
28,2741,players_3,AlwaysCallPlayer,lost,lost_game,small,one_pair,100000,97160.0,96750.0,-410.0
28,2742,players_3,AlwaysCallPlayer,lost,lost_game,big,high_card,100000,96750.0,96340.0,-410.0
28,2743,players_3,AlwaysCallPlayer,won,won_game,None,two_pair,100000,96340.0,96370.0,30.0
28,2744,players_3,AlwaysCallPlayer,won,won_game,None,two_pair,100000,96370.0,97900.0,1530.0
28,2745,players_3,AlwaysCallPlayer,lost,lost_game,small,two_pair,100000,97900.0,97890.0,-10.0
28,2746,players_3,AlwaysCallPlayer,lost,lost_game,big,high_card,100000,97890.0,97880.0,-10.0
28,2747,players_3,AlwaysCallPlayer,won,won_game,None,one_pair,100000,97880.0,97910.0,30.0
28,2748,players_3,AlwaysCallPlayer,won,won_game,None,one_pair,100000,97910.0,97920.0,10.0
28,2749,players_3,AlwaysCallPlayer,lost,lost_game,small,one_pair,100000,97920.0,97110.0,-810.0
28,2750,players_3,AlwaysCallPlayer,lost,lost_game,big,high_card,100000,97110.0,97100.0,-10.0
28,2751,players_3,AlwaysCallPlayer,lost,lost_game,None,one_pair,100000,97100.0,97090.0,-10.0
28,2752,players_3,AlwaysCallPlayer,won,won_game,None,two_pair,100000,97090.0,97720.0,630.0
28,2753,players_3,AlwaysCallPlayer,lost,lost_game,small,three_of_kind,100000,97720.0,97710.0,-10.0
28,2754,players_3,AlwaysCallPlayer,lost,lost_game,big,one_pair,100000,97710.0,97300.0,-410.0
28,2755,players_3,AlwaysCallPlayer,lost,lost_game,None,one_pair,100000,97300.0,97290.0,-10.0
28,2756,players_3,AlwaysCallPlayer,won,won_game,None,one_pair,100000,97290.0,97320.0,30.0
28,2757,players_3,AlwaysCallPlayer,lost,lost_game,small,one_pair,100000,97320.0,97310.0,-10.0
28,2758,players_3,AlwaysCallPlayer,won,won_game,big,two_pair,100000,97310.0,97340.0,30.0
28,2759,players_3,AlwaysCallPlayer,lost,lost_game,None,two_pair,100000,97340.0,97330.0,-10.0
28,2760,players_3,AlwaysCallPlayer,lost,lost_game,None,one_pair,100000,97330.0,97220.0,-110.0
28,2761,players_3,AlwaysCallPlayer,won,won_game,small,two_pair,100000,97220.0,97250.0,30.0
28,2762,players_3,AlwaysCallPlayer,lost,lost_game,big,one_pair,100000,97250.0,97240.0,-10.0
28,2763,players_3,AlwaysCallPlayer,lost,lost_game,None,one_pair,100000,97240.0,96630.0,-610.0
28,2764,players_3,AlwaysCallPlayer,won,won_game,None,one_pair,100000,96630.0,96660.0,30.0
28,2765,players_3,AlwaysCallPlayer,lost,lost_game,small,high_card,100000,96660.0,96650.0,-10.0
28,2766,players_3,AlwaysCallPlayer,won,won_game,big,one_pair,100000,96650.0,96680.0,30.0
28,2767,players_3,AlwaysCallPlayer,lost,lost_game,None,high_card,100000,96680.0,96370.0,-310.0
28,2768,players_3,AlwaysCallPlayer,lost,lost_game,None,one_pair,100000,96370.0,96360.0,-10.0
28,2769,players_3,AlwaysCallPlayer,lost,lost_game,small,three_of_kind,100000,96360.0,96350.0,-10.0
28,2770,players_3,AlwaysCallPlayer,lost,lost_game,big,one_pair,100000,96350.0,95640.0,-710.0
28,2771,players_3,AlwaysCallPlayer,lost,lost_game,None,one_pair,100000,95640.0,95630.0,-10.0
28,2772,players_3,AlwaysCallPlayer,won,won_game,None,one_pair,100000,95630.0,96560.0,930.0
28,2773,players_3,AlwaysCallPlayer,lost,lost_game,small,one_pair,100000,96560.0,96550.0,-10.0
28,2774,players_3,AlwaysCallPlayer,lost,lost_game,big,one_pair,100000,96550.0,95940.0,-610.0
28,2775,players_3,AlwaysCallPlayer,lost,lost_game,None,one_pair,100000,95940.0,95130.0,-810.0
28,2776,players_3,AlwaysCallPlayer,lost,lost_game,None,one_pair,100000,95130.0,94920.0,-210.0
28,2777,players_3,AlwaysCallPlayer,lost,lost_game,small,one_pair,100000,94920.0,94910.0,-10.0
28,2778,players_3,AlwaysCallPlayer,lost,lost_game,big,high_card,100000,94910.0,94400.0,-510.0
28,2779,players_3,AlwaysCallPlayer,lost,lost_game,None,two_pair,100000,94400.0,94390.0,-10.0
28,2780,players_3,AlwaysCallPlayer,lost,lost_game,None,one_pair,100000,94390.0,94380.0,-10.0
28,2781,players_3,AlwaysCallPlayer,lost,lost_game,small,two_pair,100000,94380.0,93870.0,-510.0
28,2782,players_3,AlwaysCallPlayer,lost,lost_game,big,one_pair,100000,93870.0,93860.0,-10.0
28,2783,players_3,AlwaysCallPlayer,lost,lost_game,None,two_pair,100000,93860.0,93850.0,-10.0
28,2784,players_3,AlwaysCallPlayer,lost,lost_game,None,one_pair,100000,93850.0,93840.0,-10.0
28,2785,players_3,AlwaysCallPlayer,won,won_game,small,full_house,100000,93840.0,93870.0,30.0
28,2786,players_3,AlwaysCallPlayer,lost,lost_game,big,high_card,100000,93870.0,93860.0,-10.0
28,2787,players_3,AlwaysCallPlayer,lost,lost_game,None,one_pair,100000,93860.0,93050.0,-810.0
28,2788,players_3,AlwaysCallPlayer,lost,lost_game,None,two_pair,100000,93050.0,93040.0,-10.0
28,2789,players_3,AlwaysCallPlayer,lost,lost_game,small,one_pair,100000,93040.0,93030.0,-10.0
28,2790,players_3,AlwaysCallPlayer,lost,lost_game,big,one_pair,100000,93030.0,92620.0,-410.0
28,2791,players_3,AlwaysCallPlayer,lost,lost_game,None,one_pair,100000,92620.0,92610.0,-10.0
28,2792,players_3,AlwaysCallPlayer,lost,lost_game,None,one_pair,100000,92610.0,92600.0,-10.0
28,2793,players_3,AlwaysCallPlayer,lost,lost_game,small,one_pair,100000,92600.0,92290.0,-310.0
28,2794,players_3,AlwaysCallPlayer,lost,lost_game,big,high_card,100000,92290.0,91780.0,-510.0
28,2795,players_3,AlwaysCallPlayer,lost,lost_game,None,one_pair,100000,91780.0,91770.0,-10.0
28,2796,players_3,AlwaysCallPlayer,lost,lost_game,None,one_pair,100000,91770.0,91260.0,-510.0
28,2797,players_3,AlwaysCallPlayer,won,won_game,small,one_pair,100000,91260.0,91290.0,30.0
28,2798,players_3,AlwaysCallPlayer,won,won_game,big,two_pair,100000,91290.0,91320.0,30.0
28,2799,players_3,AlwaysCallPlayer,lost,lost_game,None,high_card,100000,91320.0,91310.0,-10.0
28,2800,players_3,AlwaysCallPlayer,lost,lost_game,None,one_pair,100000,91310.0,90800.0,-510.0
28,2701,players_4,SmartPlayer,lost,fold,big,,100000,100000,99990,-10
28,2702,players_4,SmartPlayer,lost,fold,None,,100000,99990,99980,-10
28,2703,players_4,SmartPlayer,lost,fold,None,,100000,99980,99970,-10
28,2704,players_4,SmartPlayer,won,won_game,small,two_pair,100000,99970,100900.0,930.0
28,2705,players_4,SmartPlayer,won,won_game,big,straight,100000,100900.0,101510.0,610.0
28,2706,players_4,SmartPlayer,lost,fold,None,straight,100000,101510.0,101500.0,-10.0
28,2707,players_4,SmartPlayer,lost,lost_game,None,one_pair,100000,101500.0,101190.0,-310.0
28,2708,players_4,SmartPlayer,lost,fold,small,one_pair,100000,101190.0,101180.0,-10.0
28,2709,players_4,SmartPlayer,lost,fold,big,one_pair,100000,101180.0,101170.0,-10.0
28,2710,players_4,SmartPlayer,lost,fold,None,one_pair,100000,101170.0,101160.0,-10.0
28,2711,players_4,SmartPlayer,lost,fold,None,one_pair,100000,101160.0,101150.0,-10.0
28,2712,players_4,SmartPlayer,lost,fold,small,one_pair,100000,101150.0,101140.0,-10.0
28,2713,players_4,SmartPlayer,lost,fold,big,one_pair,100000,101140.0,101130.0,-10.0
28,2714,players_4,SmartPlayer,lost,fold,None,one_pair,100000,101130.0,101120.0,-10.0
28,2715,players_4,SmartPlayer,lost,fold,None,one_pair,100000,101120.0,101110.0,-10.0
28,2716,players_4,SmartPlayer,lost,fold,small,one_pair,100000,101110.0,101100.0,-10.0
28,2717,players_4,SmartPlayer,lost,fold,big,one_pair,100000,101100.0,101090.0,-10.0
28,2718,players_4,SmartPlayer,won,won_game,None,one_pair,100000,101090.0,102320.0,1230.0
28,2719,players_4,SmartPlayer,lost,fold,None,one_pair,100000,102320.0,102310.0,-10.0
28,2720,players_4,SmartPlayer,won,won_game,small,two_pair,100000,102310.0,103240.0,930.0
28,2721,players_4,SmartPlayer,lost,fold,big,two_pair,100000,103240.0,103230.0,-10.0
28,2722,players_4,SmartPlayer,lost,fold,None,two_pair,100000,103230.0,103220.0,-10.0
28,2723,players_4,SmartPlayer,lost,fold,None,two_pair,100000,103220.0,103210.0,-10.0
28,2724,players_4,SmartPlayer,lost,fold,small,two_pair,100000,103210.0,103200.0,-10.0
28,2725,players_4,SmartPlayer,lost,fold,big,two_pair,100000,103200.0,103190.0,-10.0
28,2726,players_4,SmartPlayer,lost,fold,None,two_pair,100000,103190.0,103080.0,-110.0
28,2727,players_4,SmartPlayer,lost,fold,None,two_pair,100000,103080.0,103070.0,-10.0
28,2728,players_4,SmartPlayer,lost,fold,small,two_pair,100000,103070.0,103060.0,-10.0
28,2729,players_4,SmartPlayer,won,won_game,big,two_pair,100000,103060.0,105490.0,2430.0
28,2730,players_4,SmartPlayer,lost,fold,None,two_pair,100000,105490.0,105480.0,-10.0
28,2731,players_4,SmartPlayer,lost,fold,None,two_pair,100000,105480.0,105470.0,-10.0
28,2732,players_4,SmartPlayer,lost,lost_game,small,straight,100000,105470.0,105160.0,-310.0
28,2733,players_4,SmartPlayer,lost,fold,big,straight,100000,105160.0,105150.0,-10.0
28,2734,players_4,SmartPlayer,won,won_game,None,two_pair,100000,105150.0,105480.0,330.0
28,2735,players_4,SmartPlayer,lost,fold,None,two_pair,100000,105480.0,105370.0,-110.0
28,2736,players_4,SmartPlayer,lost,fold,small,two_pair,100000,105370.0,105360.0,-10.0
28,2737,players_4,SmartPlayer,lost,fold,big,two_pair,100000,105360.0,105350.0,-10.0
28,2738,players_4,SmartPlayer,lost,lost_game,None,two_pair,100000,105350.0,104640.0,-710.0
28,2739,players_4,SmartPlayer,lost,fold,None,two_pair,100000,104640.0,104330.0,-310.0
28,2740,players_4,SmartPlayer,lost,fold,small,two_pair,100000,104330.0,104320.0,-10.0
28,2741,players_4,SmartPlayer,lost,fold,big,two_pair,100000,104320.0,103910.0,-410.0
28,2742,players_4,SmartPlayer,lost,fold,None,two_pair,100000,103910.0,103500.0,-410.0
28,2743,players_4,SmartPlayer,lost,fold,None,two_pair,100000,103500.0,103490.0,-10.0
28,2744,players_4,SmartPlayer,lost,lost_game,small,one_pair,100000,103490.0,102980.0,-510.0
28,2745,players_4,SmartPlayer,lost,fold,big,one_pair,100000,102980.0,102970.0,-10.0
28,2746,players_4,SmartPlayer,lost,fold,None,one_pair,100000,102970.0,102960.0,-10.0
28,2747,players_4,SmartPlayer,lost,lost_game,None,one_pair,100000,102960.0,102950.0,-10.0
28,2748,players_4,SmartPlayer,lost,fold,small,one_pair,100000,102950.0,102940.0,-10.0
28,2749,players_4,SmartPlayer,won,won_game,big,three_of_kind,100000,102940.0,105370.0,2430.0
28,2750,players_4,SmartPlayer,lost,lost_game,None,one_pair,100000,105370.0,105360.0,-10.0
28,2751,players_4,SmartPlayer,lost,fold,None,one_pair,100000,105360.0,105350.0,-10.0
28,2752,players_4,SmartPlayer,lost,lost_game,small,one_pair,100000,105350.0,105140.0,-210.0
28,2753,players_4,SmartPlayer,lost,fold,big,one_pair,100000,105140.0,105130.0,-10.0
28,2754,players_4,SmartPlayer,won,won_game,None,straight,100000,105130.0,105540.0,410.0
28,2755,players_4,SmartPlayer,lost,fold,None,straight,100000,105540.0,105530.0,-10.0
28,2756,players_4,SmartPlayer,lost,fold,small,straight,100000,105530.0,105520.0,-10.0
28,2757,players_4,SmartPlayer,lost,fold,big,straight,100000,105520.0,105510.0,-10.0
28,2758,players_4,SmartPlayer,lost,fold,None,straight,100000,105510.0,105500.0,-10.0
28,2759,players_4,SmartPlayer,lost,fold,None,straight,100000,105500.0,105490.0,-10.0
28,2760,players_4,SmartPlayer,won,won_game,small,two_pair,100000,105490.0,105820.0,330.0
28,2761,players_4,SmartPlayer,lost,fold,big,two_pair,100000,105820.0,105810.0,-10.0
28,2762,players_4,SmartPlayer,lost,fold,None,two_pair,100000,105810.0,105800.0,-10.0
28,2763,players_4,SmartPlayer,won,won_game,None,three_of_kind,100000,105800.0,107630.0,1830.0
28,2764,players_4,SmartPlayer,lost,fold,small,three_of_kind,100000,107630.0,107620.0,-10.0
28,2765,players_4,SmartPlayer,lost,fold,big,three_of_kind,100000,107620.0,107610.0,-10.0
28,2766,players_4,SmartPlayer,lost,fold,None,three_of_kind,100000,107610.0,107600.0,-10.0
28,2767,players_4,SmartPlayer,lost,fold,None,three_of_kind,100000,107600.0,107290.0,-310.0
28,2768,players_4,SmartPlayer,lost,fold,small,three_of_kind,100000,107290.0,107280.0,-10.0
28,2769,players_4,SmartPlayer,lost,fold,big,three_of_kind,100000,107280.0,107270.0,-10.0
28,2770,players_4,SmartPlayer,won,won_game,None,two_pair,100000,107270.0,109400.0,2130.0
28,2771,players_4,SmartPlayer,lost,fold,None,two_pair,100000,109400.0,109390.0,-10.0
28,2772,players_4,SmartPlayer,lost,lost_game,small,one_pair,100000,109390.0,109080.0,-310.0
28,2773,players_4,SmartPlayer,lost,fold,big,one_pair,100000,109080.0,109070.0,-10.0
28,2774,players_4,SmartPlayer,lost,lost_game,None,one_pair,100000,109070.0,108460.0,-610.0
28,2775,players_4,SmartPlayer,won,won_game,None,two_pair,100000,108460.0,110890.0,2430.0
28,2776,players_4,SmartPlayer,won,won_game,small,straight,100000,110890.0,111520.0,630.0
28,2777,players_4,SmartPlayer,lost,fold,big,straight,100000,111520.0,111510.0,-10.0
28,2778,players_4,SmartPlayer,won,won_game,None,one_pair,100000,111510.0,113040.0,1530.0
28,2779,players_4,SmartPlayer,lost,fold,None,one_pair,100000,113040.0,113030.0,-10.0
28,2780,players_4,SmartPlayer,lost,fold,small,one_pair,100000,113030.0,113020.0,-10.0
28,2781,players_4,SmartPlayer,won,won_game,big,full_house,100000,113020.0,114550.0,1530.0
28,2782,players_4,SmartPlayer,lost,fold,None,full_house,100000,114550.0,114540.0,-10.0
28,2783,players_4,SmartPlayer,lost,fold,None,full_house,100000,114540.0,114530.0,-10.0
28,2784,players_4,SmartPlayer,lost,fold,small,full_house,100000,114530.0,114520.0,-10.0
28,2785,players_4,SmartPlayer,lost,fold,big,full_house,100000,114520.0,114510.0,-10.0
28,2786,players_4,SmartPlayer,lost,fold,None,full_house,100000,114510.0,114500.0,-10.0
28,2787,players_4,SmartPlayer,lost,lost_game,None,one_pair,100000,114500.0,113690.0,-810.0
28,2788,players_4,SmartPlayer,lost,lost_game,small,two_pair,100000,113690.0,113680.0,-10.0
28,2789,players_4,SmartPlayer,lost,fold,big,two_pair,100000,113680.0,113670.0,-10.0
28,2790,players_4,SmartPlayer,lost,lost_game,None,two_pair,100000,113670.0,113260.0,-410.0
28,2791,players_4,SmartPlayer,lost,fold,None,two_pair,100000,113260.0,113250.0,-10.0
28,2792,players_4,SmartPlayer,lost,fold,small,two_pair,100000,113250.0,113240.0,-10.0
28,2793,players_4,SmartPlayer,won,won_game,big,three_of_kind,100000,113240.0,114170.0,930.0
28,2794,players_4,SmartPlayer,won,won_game,None,one_pair,100000,114170.0,115700.0,1530.0
28,2795,players_4,SmartPlayer,lost,fold,None,one_pair,100000,115700.0,115690.0,-10.0
28,2796,players_4,SmartPlayer,won,won_game,small,one_pair,100000,115690.0,117220.0,1530.0
28,2797,players_4,SmartPlayer,lost,fold,big,one_pair,100000,117220.0,117210.0,-10.0
28,2798,players_4,SmartPlayer,lost,lost_game,None,two_pair,100000,117210.0,117200.0,-10.0
28,2799,players_4,SmartPlayer,lost,fold,None,two_pair,100000,117200.0,117190.0,-10.0
28,2800,players_4,SmartPlayer,won,won_game,small,one_pair,100000,117190.0,118720.0,1530.0
